ID,Player,Team,GP,G,A,TP,PPG,PIM,PM
1,Jack Dugan (LW/RW),Providence College,34,10,42,52,1.53,64,13
2,Jordan Kawaguchi (C),University of North Dakota,33,15,30,45,1.36,8,21
3,Marc Michaelis (LW/C),Minnesota State University (Mankato),31,20,24,44,1.42,8,20
4,Tyce Thompson (RW/C),Providence College,34,19,25,44,1.29,29,8
5,Nick Abruzzese (LW/C),Harvard University,31,14,30,44,1.42,4,8
6,David Farrance (D),Boston University,34,14,29,43,1.26,20,6
7,Alex Newhook (C/LW),Boston College,34,19,23,42,1.24,8,28
8,Julius Mattila (C),Boston College,34,10,32,42,1.24,10,21
9,Mitchell Fossier (LW),University of Maine,34,10,32,42,1.24,12,16
10,James Sanchez (LW),Arizona State University,36,10,30,40,1.11,24,7
11,Scott Perunovich (D),University of Minnesota-Duluth,34,6,34,40,1.18,64,18
12,Griffin Loughran (F),Northern Michigan University,37,23,16,39,1.05,93,9
13,Jack Drury (C),Harvard University,28,20,19,39,1.39,16,9
14,David Cotton (C),Boston College,32,15,24,39,1.22,46,15
15,Johnny Walker (RW),Arizona State University,36,20,18,38,1.06,22,12
16,Nate Sucese (LW),Penn State University,34,11,27,38,1.12,16,8
17,Odeen Tufto (C),Quinnipiac University,34,7,31,38,1.12,10,8
18,John Leonard (LW/RW),UMass,33,27,10,37,1.12,8,17
19,Jason Cotton (C),Sacred Heart University,34,20,17,37,1.09,14,20
20,Tyler Madden (C),Northeastern University,27,19,18,37,1.37,34,4
21,Patrick Harper (C/LW),Boston University,32,14,23,37,1.16,6,11
22,Tim Doherty (C/LW),University of Maine,34,14,23,37,1.09,32,14
23,Parker Tuomie (RW),Minnesota State University (Mankato),37,14,23,37,1.00,16,13
24,Brinson Pasichnuk (D),Arizona State University,36,11,26,37,1.03,18,4
25,Cole Caufield (LW/RW),University of Wisconsin,36,19,17,36,1.00,6,-3
26,Gordie Green (C/RW),Miami University (Ohio),34,14,22,36,1.06,26,0
27,Casey Dornbach (C/W),Harvard University,31,12,24,36,1.16,2,9
28,Trevor Zegras (C/W),Boston University,33,11,25,36,1.09,43,8
29,Max Humitz (C/LW),Lake Superior State University,41,22,13,35,0.85,62,3
30,Hugh McGing (LW/C),Western Michigan University,35,13,22,35,1.00,52,18
31,Mathias Emilio Pettersen (C/LW),University of Denver,36,13,22,35,0.97,16,-1
32,Alec Rauhauser (D),Bowling Green State University,38,11,24,35,0.92,40,11
33,Adam Brady (C/LW),Bemidji State University,37,19,15,34,0.92,2,0
34,Owen Sillinger (C/LW),Bemidji State University,37,14,20,34,0.92,36,11
35,Evan Barratt (C/LW),Penn State University,34,12,22,34,1.00,28,12
36,Connor Ford (C),Bowling Green State University,36,12,22,34,0.94,16,-1
37,Tanner Laczynski (C),Ohio State University,36,11,23,34,0.94,22,9
38,Brandon Kruse (LW),Bowling Green State University,38,9,25,34,0.89,24,1
39,Drew O'Connor (LW/RW),Dartmouth College,31,21,12,33,1.06,42,3
40,Logan Hutsko (RW/C),Boston College,30,19,14,33,1.10,16,17
41,Cole Koepke (LW/RW/RW),University of Minnesota-Duluth,34,16,17,33,0.97,16,14
42,Patrick Khodorenko (C),Michigan State University,36,16,17,33,0.92,20,0
43,Noah Cates (LW),University of Minnesota-Duluth,34,14,19,33,0.97,35,7
44,Steven Jandric (LW),University of Alaska-Fairbanks,35,13,20,33,0.94,47,4
45,Mike Lee (D),Sacred Heart University,33,5,28,33,1.00,20,22
46,Patrick Curry (C/LW),Boston University,34,19,13,32,0.94,28,10
47,Nick Hutchison (C/LW),Canisius College,31,18,14,32,1.03,49,3
48,Austin McIlmurray (RW),Sacred Heart University,34,18,14,32,0.94,6,4
49,Matt Hoover (LW),Canisius College,36,15,17,32,0.89,60,-3
50,Morgan Barron (C/W),Cornell University,29,14,18,32,1.10,24,17
51,Haralds Egle (C/RW),Clarkson University,32,14,18,32,1.00,22,9
52,Alex Limoges (LW/C),Penn State University,30,11,21,32,1.07,8,11
53,Josh Maniscalco (D),Arizona State University,36,11,21,32,0.89,38,12
54,Ian Mitchell (D),University of Denver,36,10,22,32,0.89,16,7
55,Chris Wilkie (RW/LW),Colorado College,34,23,8,31,0.91,36,-9
56,Carson Meyer (RW/LW),Ohio State University,35,17,14,31,0.89,26,8
57,Darien Craighead (RW/C),Northern Michigan University,36,15,16,31,0.86,33,0
58,Jake Slaker (C),University of Michigan,33,14,17,31,0.94,14,8
59,Zach Solow (C/RW),Northeastern University,34,13,18,31,0.91,34,2
60,Karch Bachman (LW/C),Miami University (Ohio),34,10,21,31,0.91,18,3
61,Casey Gilling (C),Miami University (Ohio),34,9,22,31,0.91,28,-3
62,Jack Rathbone (D),Harvard University,28,7,24,31,1.11,16,0
63,Lucas Sowder (LW),Minnesota State University (Mankato),31,6,25,31,1.00,4,15
64,Ryan Shea (D),Northeastern University,34,5,26,31,0.91,10,0
65,Jakov Novak (LW/C),Bentley University,35,16,14,30,0.86,84,3
66,Matt Tugnutt (LW/C),Sacred Heart University,31,14,16,30,0.97,17,21
67,Eduards Tralmaks (W/C),University of Maine,34,14,16,30,0.88,13,10
68,Jonathan Desbiens (LW),Bentley University,35,13,17,30,0.86,20,-1
69,Charlie Gerard (C/RW),Minnesota State University (Mankato),37,13,17,30,0.81,18,17
70,Nick Halloran (RW),Colorado College,33,12,18,30,0.91,12,-8
71,Sammy Walker (C/RW),University of Minnesota,37,11,19,30,0.81,33,-8
72,Cole Hults (D),Penn State University,34,8,22,30,0.88,18,23
73,Brett Stapley (C),University of Denver,35,5,25,30,0.86,41,15
74,Shawn Cameron (LW/RW),RIT (Rochester Inst. of Tech.),36,18,11,29,0.81,16,5
75,Mitchell Chaffee (RW),UMass,30,16,13,29,0.97,16,16
76,Dawson DiPietro (LW),Western Michigan University,35,12,17,29,0.83,46,4
77,Aaron Miller (F),Bemidji State University,36,12,17,29,0.81,61,7
78,Anthony Rinaldi (LW/RW),Union College,37,9,20,29,0.78,12,0
79,Devin Brosseau (C/RW),Clarkson University,28,8,21,29,1.04,20,8
80,Max Gildon (D),University of New Hampshire,34,7,22,29,0.85,40,-2
81,Matt Kiersted (D),University of North Dakota,33,6,23,29,0.88,50,22
82,Shane Pinto (C),University of North Dakota,33,16,12,28,0.85,46,19
83,Westin Michaud (LW/C),University of North Dakota,35,16,12,28,0.80,14,19
84,Vincent De Mey (F),Northern Michigan University,38,15,13,28,0.74,14,-7
85,Cole Guttman (C/RW),University of Denver,35,14,14,28,0.80,22,2
86,Collin Adams (LW/C),University of North Dakota,35,12,16,28,0.80,18,25
87,Ashton Calder (F),Lake Superior State University,41,12,16,28,0.68,20,4
88,Blake Christensen (LW),American International College,34,11,17,28,0.82,12,2
89,Nick Prkusic (F),Robert Morris University,34,11,17,28,0.82,28,0
90,Alex Steeves (LW/C),University of Notre Dame,36,11,17,28,0.78,10,6
91,Martin Mellberg (RW),American International College,34,9,19,28,0.82,19,8
92,Ben Freeman (RW/C),University of Connecticut,33,7,21,28,0.85,0,5
93,Wyatt Kalynuk (D),University of Wisconsin,36,7,21,28,0.78,24,-5
94,Braeden Tuck (F),Sacred Heart University,34,5,23,28,0.82,2,16
95,Michael Callahan (D),Providence College,34,5,23,28,0.82,20,1
96,Liam Finlay (RW/C),University of Denver,36,5,23,28,0.78,28,8
97,Adam Brubacher (D),RIT (Rochester Inst. of Tech.),36,4,24,28,0.78,29,12
98,Cameron Wright (RW),Bowling Green State University,38,20,7,27,0.71,22,1
99,Curtis Hall (C),Yale University,28,17,10,27,0.96,39,14
100,Taylor Ward (RW),University of Nebraska-Omaha,32,16,11,27,0.84,42,-3
101,Alec Broetzman (LW),Michigan Tech,39,16,11,27,0.69,23,6
102,Greg Printz (LW/RW),Providence College,34,15,12,27,0.79,21,8
103,Tyler Irvine (RW),Merrimack College,32,13,14,27,0.84,12,-9
104,Josh Dunne (C/LW),Clarkson University,32,13,14,27,0.84,30,9
105,Cam Morrison (LW),University of Notre Dame,37,13,14,27,0.73,8,10
106,Jack Billings (RW),Niagara University,34,12,15,27,0.79,8,12
107,Easton Brodzinski (RW/LW),St. Cloud State University,34,12,15,27,0.79,37,-17
108,Kevin Conley (LW/C),University of Nebraska-Omaha,36,12,15,27,0.75,29,1
109,Trenton Bliss (LW/C),Michigan Tech,39,12,15,27,0.69,35,4
110,Will Graber (C),Dartmouth College,26,11,16,27,1.04,30,-6
111,Aidan McDonough (LW/RW),Northeastern University,31,11,16,27,0.87,10,-4
112,Alex Barber (F),Bowling Green State University,38,11,16,27,0.71,26,-6
113,Marc Johnstone (RW/LW),Sacred Heart University,34,9,18,27,0.79,14,8
114,Nathan Smith (C),Minnesota State University (Mankato),35,9,18,27,0.77,37,10
115,Max Newton (C/RW),University of Alaska-Fairbanks,36,9,18,27,0.75,43,3
116,Brannon McManus (C/RW),University of Minnesota,37,9,18,27,0.73,10,10
117,Reilly Walsh (D),Harvard University,30,8,19,27,0.90,8,5
118,Joseph Nardi (C/LW),Northern Michigan University,38,8,19,27,0.71,12,17
119,Louis Boudon (C),Lake Superior State University,40,6,21,27,0.68,22,7
120,Quinn Preston (F),Ohio State University,34,15,11,26,0.76,35,4
121,Nick Swaney (RW),University of Minnesota-Duluth,31,12,14,26,0.84,4,8
122,Gustaf Westlund (C/W),Ohio State University,34,12,14,26,0.76,43,9
123,Austin Rueschhoff (F),Western Michigan University,36,12,14,26,0.72,24,9
124,Pierre-Luc Veillette (C),Lake Superior State University,41,12,14,26,0.63,4,3
125,Ben Meyers (C/LW),University of Minnesota,37,10,16,26,0.70,8,7
126,Alex Turcotte (C/LW),University of Wisconsin,29,9,17,26,0.90,20,-10
127,Matt Boldy (LW/RW),Boston College,34,9,17,26,0.76,8,16
128,Brady Tomlak (C),Air Force Academy,35,9,17,26,0.74,37,10
129,Jake Hamacher (LW),RIT (Rochester Inst. of Tech.),36,9,17,26,0.72,0,0
130,Brenden Locke (C),Cornell University,29,8,18,26,0.90,4,20
131,Zach Tsekos (C),Clarkson University,34,8,18,26,0.76,8,3
132,Nick Poehling (C/LW),St. Cloud State University,34,8,18,26,0.76,28,0
133,Matt Stief (D),Canisius College,36,3,23,26,0.72,8,-6
134,Wyatt Bongiovanni (C/LW),Quinnipiac University,34,15,10,25,0.74,36,9
135,Roman Ahcan (LW/C),University of Wisconsin,33,14,11,25,0.76,43,7
136,Justin Richards (C),University of Minnesota-Duluth,34,14,11,25,0.74,14,14
137,Mike Hardman (W/C),Boston College,34,12,13,25,0.74,10,21
138,Quin Foreman (RW),Dartmouth College,31,11,14,25,0.81,16,-8
139,Liam Folkes (C),Penn State University,33,11,14,25,0.76,6,14
140,Brandon Biro (C/LW),Penn State University,25,10,15,25,1.00,8,7
141,Julian Napravnik (RW),Minnesota State University (Mankato),35,9,16,25,0.71,8,17
142,Dallas Gerads (C/LW),Minnesota State University (Mankato),33,8,17,25,0.76,30,19
143,Jacob Bernard-Docker (D),University of North Dakota,32,7,18,25,0.78,12,21
144,Jack Ahcan (D),St. Cloud State University,33,7,18,25,0.76,48,-8
145,Max Johnson (C),Bowling Green State University,34,6,19,25,0.74,8,3
146,Philip Beaulieu (D),Northern Michigan University,38,6,19,25,0.66,32,7
147,Brennan Kapcheck (D),American International College,33,2,23,25,0.76,61,11
148,Willie Knierim (RW),Arizona State University,36,15,9,24,0.67,51,12
149,Justin Pearson (LW),Yale University,31,14,10,24,0.77,16,10
150,Alex Whelan (RW),Quinnipiac University,29,13,11,24,0.83,10,16
151,Patrick Grasso (RW),University of New Hampshire,34,13,11,24,0.71,8,-5
152,Reggie Lutz (RW),Minnesota State University (Mankato),38,13,11,24,0.63,12,16
153,Carter Turnbull (RW/C),University of Connecticut,31,12,12,24,0.77,8,13
154,Bobby Brink (RW),University of Denver,28,11,13,24,0.86,12,1
155,Aapeli Räsänen (C),Boston College,34,11,13,24,0.71,14,14
156,Matt Gosiewski (C),Bentley University,35,10,14,24,0.69,2,3
157,Ty Pelton-Byce (F),University of Wisconsin,32,9,15,24,0.75,6,2
158,Jordan Kaplan (RW/C),Sacred Heart University,34,9,15,24,0.71,12,6
159,Elijah Gonsalves (RW/C),RIT (Rochester Inst. of Tech.),35,9,15,24,0.69,37,-2
160,Caleb Moretz (RW/C),RIT (Rochester Inst. of Tech.),36,9,15,24,0.67,24,5
161,Blake McLaughlin (LW/C),University of Minnesota,37,8,16,24,0.65,34,-2
162,Sam Hentges (C/LW),St. Cloud State University,28,7,17,24,0.86,20,-9
163,Connor Mackey (D),Minnesota State University (Mankato),36,7,17,24,0.67,29,23
164,Matt Baker (C),Dartmouth College,31,6,18,24,0.77,32,8
165,Matt Brown (LW/RW),UMass-Lowell,33,6,18,24,0.73,10,0
166,Hampus Eriksson (C/W),Lake Superior State University,41,6,18,24,0.59,18,3
167,Ioannis Kaldis (D),Cornell University,29,5,19,24,0.83,4,13
168,Tanner Palocsik (D),Dartmouth College,31,5,19,24,0.77,12,2
169,Elias Rosén (D),Bemidji State University,35,5,19,24,0.69,10,7
170,Scott Reedy (C),University of Minnesota,35,15,8,23,0.66,12,5
171,Will Calverley (C),RIT (Rochester Inst. of Tech.),32,13,10,23,0.72,20,1
172,Tobias Fladeby (LW/RW),American International College,32,12,11,23,0.72,14,5
173,Carl Berglund (C/LW),UMass-Lowell,34,12,11,23,0.68,12,12
174,Vladislav Firstov (LW),University of Connecticut,34,11,12,23,0.68,31,14
175,Wade Allison (RW/LW),Western Michigan University,26,10,13,23,0.88,17,11
176,Dominic Franco (RW/C),Army (U.S. Military Academy),33,10,13,23,0.70,40,5
177,Derek Daschke (D),Miami University (Ohio),34,10,13,23,0.68,18,0
178,Neil Robinson (LW),College of the Holy Cross,36,10,13,23,0.64,14,-5
179,William Lockwood (RW),University of Michigan,33,9,14,23,0.70,18,10
180,Mike O'Leary (C),University of Notre Dame,37,9,14,23,0.62,20,-2
181,Jackson Cates (C/LW),University of Minnesota-Duluth,29,8,15,23,0.79,6,4
182,Tyler Welsh (C/RW),Yale University,32,8,15,23,0.72,14,9
183,Jáchym Kondelík (C/W),University of Connecticut,34,8,15,23,0.68,25,6
184,Austin Magera (C),Sacred Heart University,34,8,15,23,0.68,26,6
185,Zac Risteau (C/LW),St. Lawrence University,34,7,16,23,0.68,10,-15
186,Chase Zieky (RW/LW),RPI (Rensselaer Polytech. Inst.),34,7,16,23,0.68,12,4
187,Alex Smith (D/RW),Michigan Tech,39,7,16,23,0.59,20,12
188,Charlie Kelleher (RW),University of New Hampshire,29,6,17,23,0.79,10,2
189,Luke Santerno (F),Bentley University,36,6,17,23,0.64,39,-2
190,Zac Jones (D),UMass,32,3,20,23,0.72,24,12
191,Zachary Mirageas (D),Air Force Academy,36,3,20,23,0.64,41,-18
192,Angus Crookshank (LW/RW),University of New Hampshire,34,16,6,22,0.65,39,-4
193,Hugo Reinhardt (C),American International College,34,13,9,22,0.65,40,2
194,Alexandre Payusov (RW),University of Connecticut,33,12,10,22,0.67,20,6
195,Brian Halonen (LW/RW),Michigan Tech,39,12,10,22,0.56,22,4
196,Chase Gresock (F),Merrimack College,28,11,11,22,0.79,10,-17
197,Ben Sokay (C),Niagara University,33,11,11,22,0.67,6,12
198,Andre Ghantous (RW/LW),Northern Michigan University,36,11,11,22,0.61,16,6
199,Brendan Hamblet (F),Bentley University,36,11,11,22,0.61,32,3
200,John Farinacci (C/RW),Harvard University,31,10,12,22,0.71,21,5
201,Tristan Mullin (C/LW),Cornell University,29,9,13,22,0.76,22,7
202,Matt Filipe (C/LW),Northeastern University,30,9,13,22,0.73,24,4
203,Parker Ford (C/RW),Providence College,31,9,13,22,0.71,22,14
204,Will Reilly (D),RPI (Rensselaer Polytech. Inst.),34,8,14,22,0.65,12,14
205,Dennis Cesana (D),Michigan State University,36,7,15,22,0.61,28,-1
206,Gabriel Seger (LW/C),Union College,37,7,15,22,0.59,8,-1
207,Logan Ferguson (RW),College of the Holy Cross,37,7,15,22,0.59,35,-5
208,Jackson Cressey (F),Princeton University,31,6,16,22,0.71,36,0
209,Chris Jandric (D),University of Alaska-Fairbanks,35,5,17,22,0.63,40,-6
210,Declan Carlile (D),Merrimack College,34,4,18,22,0.65,22,-10
211,Linus Weissbach (LW),University of Wisconsin,35,4,18,22,0.63,25,-8
212,Tyler Weiss (LW/C),University of Nebraska-Omaha,35,4,18,22,0.63,27,-2
213,Wyatt Newpower (D),University of Connecticut,34,3,19,22,0.65,20,23
214,Jake Willets (D),Ferris State University,35,3,19,22,0.63,35,-17
215,Ian Scheid (D),Minnesota State University (Mankato),37,3,19,22,0.59,26,20
216,Vito Bavaro (RW),Sacred Heart University,33,16,5,21,0.64,22,2
217,Tommy Parrottino (F),Michigan Tech,35,14,7,21,0.60,2,7
218,Kobe Roth (F),University of Minnesota-Duluth,34,13,8,21,0.62,0,6
219,Patrick Moynihan (RW),Providence College,34,13,8,21,0.62,8,0
220,P.J. Marrocco (F),Arizona State University,35,13,8,21,0.60,18,9
221,Nick Jermain (RW),Quinnipiac University,34,12,9,21,0.62,10,3
222,Paul Washe (C),Western Michigan University,34,12,9,21,0.62,26,4
223,Lee Lapid (C),Canisius College,35,11,10,21,0.60,27,-16
224,Ruslan Iskhakov (C/LW),University of Connecticut,32,9,12,21,0.66,26,9
225,Justin Young (C),University of Alaska-Fairbanks,36,9,12,21,0.58,26,4
226,Jake Coleman (F),Robert Morris University,36,9,12,21,0.58,29,8
227,Taylor Schneider (LW),Bowling Green State University,38,8,13,21,0.55,20,-12
228,Dalton Hunter (RW/LW),Mercyhurst University,36,7,14,21,0.58,41,-22
229,Cal Burke (C/RW),University of Notre Dame,37,7,14,21,0.57,2,-6
230,Alex Ierullo (LW),Bemidji State University,37,7,14,21,0.57,25,10
231,Ture Linden (C),RPI (Rensselaer Polytech. Inst.),34,6,15,21,0.62,2,7
232,Peter DiLiberatore (D),Quinnipiac University,34,6,15,21,0.62,39,10
233,Jack McBain (C/LW),Boston College,34,6,15,21,0.62,39,5
234,Sami Tavernier (RW),Merrimack College,34,6,15,21,0.62,43,-12
235,Frédéric Létourneau (C),Bowling Green State University,35,6,15,21,0.60,12,-1
236,Ben Finkelstein (D),Boston College,34,5,16,21,0.62,18,29
237,Austin Alger (F),Canisius College,34,5,16,21,0.62,24,-15
238,Colin Swoyer (D),Michigan Tech,39,4,17,21,0.54,32,3
239,Cameron Lee (D),Western Michigan University,26,3,18,21,0.81,25,11
240,Henry Thrun (D),Harvard University,31,3,18,21,0.68,12,17
241,Jordan Harris (D),Northeastern University,33,3,18,21,0.64,20,0
242,Tyler Busch (C),Arizona State University,36,3,18,21,0.58,41,15
243,Patrik Demel (D),American International College,34,2,19,21,0.62,10,12
244,Dylan Samberg (D),University of Minnesota-Duluth,28,1,20,21,0.75,18,17
245,Todd Burgess (C/W),RPI (Rensselaer Polytech. Inst.),32,14,6,20,0.63,20,3
246,Sampo Ranta (LW/RW),University of Minnesota,35,12,8,20,0.57,10,9
247,Michael Wilson (F),Army (U.S. Military Academy),27,11,9,20,0.74,30,9
248,Kylar Hope (F),University of Alaska-Fairbanks,27,10,10,20,0.74,57,-4
249,Bobby McMann (C/LW),Colgate University,34,10,10,20,0.59,58,0
250,James Anderson (RW),Mercyhurst University,36,10,10,20,0.56,7,-19
251,Benjamin Sharf (C),Colgate University,36,10,10,20,0.56,22,-2
252,Ethen Frank (RW/C),Western Michigan University,32,9,11,20,0.63,6,4
253,Connor McCarthy (D),Clarkson University,34,9,11,20,0.59,10,1
254,Bobby Trivigno (LW),UMass,34,9,11,20,0.59,20,21
255,Joel Kocur (LW/C),American International College,34,9,11,20,0.59,39,8
256,Adam Dawe (RW/C),University of Maine,34,9,11,20,0.59,41,-3
257,Jack Poehling (C/LW),St. Cloud State University,34,9,11,20,0.59,43,8
258,Kohen Olischefski (RW),University of Denver,36,9,11,20,0.56,14,4
259,Luc Brown (RW),University of Alaska-Anchorage,20,8,12,20,1.00,12,-8
260,Andre Lee (LW/C),UMass-Lowell,33,8,12,20,0.61,30,7
261,Grant Mismash (LW/C),University of North Dakota,35,8,12,20,0.57,18,17
262,Chayse Primeau (W/C),University of Nebraska-Omaha,36,8,12,20,0.56,10,1
263,Mitch Lewandowski (LW),Michigan State University,36,8,12,20,0.56,28,-8
264,Colin Theisen (C),University of Notre Dame,37,8,12,20,0.54,24,4
265,Logan Pietila (RW/C),Michigan Tech,39,8,12,20,0.51,10,4
266,Colin Bilek (RW),Army (U.S. Military Academy),33,7,13,20,0.61,33,1
267,Ryan Steele (F),Sacred Heart University,34,7,13,20,0.59,24,6
268,Maxim Andreev (C/LW),Cornell University,24,5,15,20,0.83,12,11
269,Connor Brassard (D),Bentley University,35,5,15,20,0.57,20,2
270,Michael Graham (F),University of Notre Dame,30,4,16,20,0.67,6,-2
271,Cole Gallant (C),Western Michigan University,31,4,16,20,0.65,9,12
272,Jack Suter (C/RW),UMass,33,4,16,20,0.61,10,18
273,Tommy Muck (D),Bemidji State University,37,4,16,20,0.54,10,15
274,Eric Gotz (D),Michigan Tech,38,4,16,20,0.53,10,-1
275,Spencer Stastney (D),University of Notre Dame,36,3,17,20,0.56,17,4
276,Jackson Pierson (C),University of New Hampshire,26,2,18,20,0.77,6,-8
277,Elijiah Barriga (C),American International College,28,11,8,19,0.68,12,10
278,Patrick Polino (C),RPI (Rensselaer Polytech. Inst.),34,11,8,19,0.56,18,-2
279,Tyler Ward (LW),University of Denver,36,10,9,19,0.53,6,12
280,Jonny Evans (F),University of Connecticut,27,9,10,19,0.70,4,8
281,Jared Spooner (LW),Minnesota State University (Mankato),31,9,10,19,0.61,35,19
282,Alden Dupuis (F),RIT (Rochester Inst. of Tech.),30,8,11,19,0.63,14,8
283,Denis Smirnov (RW/LW),Penn State University,31,8,11,19,0.61,6,7
284,Tyler Cline (C/LW),University of Alaska-Fairbanks,36,8,11,19,0.53,22,-5
285,Kenny Hausinger (C),UMass-Lowell,29,7,12,19,0.66,20,-1
286,Corey Andonovski (RW/LW),Princeton University,26,6,13,19,0.73,46,-9
287,Aarne Talvitie (C/LW),Penn State University,30,6,13,19,0.63,2,8
288,Brandon Koch (D),Air Force Academy,35,6,13,19,0.54,12,1
289,Justin Addamo (C/RW),Robert Morris University,36,6,13,19,0.53,26,-5
290,Oliver Chau (C),UMass,32,5,14,19,0.59,6,5
291,Bo Hanson (D),St. Lawrence University,33,5,14,19,0.58,26,-16
292,Mike Gornall (F),RPI (Rensselaer Polytech. Inst.),34,5,14,19,0.56,18,3
293,Ryan Naumovski (F),Niagara University,34,4,15,19,0.56,6,-1
294,Ty Readman (C),Northern Michigan University,38,4,15,19,0.50,8,-13
295,John Zimmerman (D),Army (U.S. Military Academy),32,2,17,19,0.59,58,-12
296,Charlie Combs (LW),Bemidji State University,33,12,6,18,0.55,18,1
297,Peter Kessel (F),College of the Holy Cross,34,12,6,18,0.53,27,-10
298,Conner Jean (C),College of the Holy Cross,36,12,6,18,0.50,45,-2
299,Michael Regush (C),Cornell University,29,11,7,18,0.62,8,8
300,Cole Smith (LW),University of North Dakota,34,11,7,18,0.53,37,6
301,Steven Ipri (F),Mercyhurst University,24,10,8,18,0.75,36,-6
302,Jasper Weatherby (C/LW),University of North Dakota,35,10,8,18,0.51,20,9
303,Mason Krueger (F),Army (U.S. Military Academy),30,9,9,18,0.60,31,2
304,Joey Abate (LW/RW),University of Nebraska-Omaha,31,9,9,18,0.58,38,2
305,Jacob Schmidt-Svejstrup (RW),University of Maine,33,9,9,18,0.55,39,-1
306,Nick Pastujov (C/LW),University of Michigan,36,9,9,18,0.50,24,5
307,Grant Jozefek (RW),Northeastern University,30,8,10,18,0.60,10,8
308,Ryner Gorowsky (RW),Bentley University,30,7,11,18,0.60,27,6
309,Luke Keenan (C),Princeton University,31,7,11,18,0.58,10,-3
310,Micah Miller (RW/C),St. Cloud State University,31,7,11,18,0.58,12,5
311,Jake Marrello (F),RPI (Rensselaer Polytech. Inst.),31,7,11,18,0.58,12,8
312,Josh Latta (F),University of Alabama-Huntsville,32,7,11,18,0.56,16,-16
313,Teemu Pulkkinen (RW),University of Nebraska-Omaha,33,7,11,18,0.55,8,-2
314,Eric MacAdams (RW),University of New Hampshire,33,7,11,18,0.55,57,-5
315,Ethan De Jong (RW/LW),Quinnipiac University,34,7,11,18,0.53,14,6
316,Logan Drevitch (LW),Merrimack College,34,7,11,18,0.53,32,-12
317,Colton Young (LW),Colgate University,35,7,11,18,0.51,4,8
318,K'Andre Miller (D),University of Wisconsin,36,7,11,18,0.50,24,-7
319,Eric Cooley (RW/LW),Niagara University,34,6,12,18,0.53,16,0
320,Ethan Somoza (LW),Bemidji State University,37,6,12,18,0.49,10,9
321,Cam Donaldson (C),Cornell University,25,5,13,18,0.72,10,18
322,Liam Blackburn (F),University of New Hampshire,34,5,13,18,0.53,10,0
323,Jordan Sandhu (C),Arizona State University,36,5,13,18,0.50,6,5
324,Will Riedell (D),Lake Superior State University,41,5,13,18,0.44,34,13
325,Ben Copeland (C),Colorado College,34,4,14,18,0.53,14,-10
326,Karlis Cukste (D),Quinnipiac University,34,4,14,18,0.53,14,0
327,Zach Uens (D),Merrimack College,34,4,14,18,0.53,68,-6
328,Ryan Brushett (C),University of Nebraska-Omaha,36,2,16,18,0.50,4,-3
329,Sam Sternschein (LW),Penn State University,29,12,5,17,0.59,10,1
330,Grant Cruikshank (C/LW),Colorado College,34,11,6,17,0.50,25,-17
331,Keaton Mastrodonato (RW/C),Canisius College,34,10,7,17,0.50,35,-4
332,Sam Saliba (F),Michigan State University,36,10,7,17,0.47,8,0
333,Rhett Kingston (LW),Western Michigan University,33,9,8,17,0.52,31,10
334,Kevin Darrar (F),College of the Holy Cross,34,9,8,17,0.50,31,-2
335,Paul McAvoy (F),Colgate University,35,9,8,17,0.49,19,3
336,Nick Cardelli (C/RW),Bemidji State University,31,8,9,17,0.55,18,-2
337,Ronnie Hein (C),Ohio State University,35,8,9,17,0.49,14,-5
338,Dylan Holloway (W/C),University of Wisconsin,35,8,9,17,0.49,49,-3
339,Rylee St. Onge (LW),University of Alaska-Anchorage,36,8,9,17,0.47,22,-16
340,Ben Berard (LW),Cornell University,27,7,10,17,0.63,4,8
341,Kohei Sato (LW),University of New Hampshire,32,7,10,17,0.53,10,4
342,Nolan Sullivan (F),University of Nebraska-Omaha,33,7,10,17,0.52,47,0
343,Robert Mastrosimone (LW/C),Boston University,34,7,10,17,0.50,10,-1
344,Logan Lambdin (LW),Michigan State University,35,7,10,17,0.49,22,3
345,Jared Cockrell (F),Colgate University,36,7,10,17,0.47,45,0
346,Drew Worrad (C),Western Michigan University,31,6,11,17,0.55,2,11
347,Luka Maver (C),American International College,32,6,11,17,0.53,8,9
348,Jack Jacome (RW/LW),Clarkson University,34,6,11,17,0.50,24,5
349,Owen Lindmark (C/RW),University of Wisconsin,36,6,11,17,0.47,8,6
350,Tate Singleton (C),Ohio State University,36,6,11,17,0.47,18,7
351,Daniel Mantenuto (C),Robert Morris University,24,5,12,17,0.71,6,-8
352,Matt Miller (D),Ohio State University,26,5,12,17,0.65,12,-6
353,Kevin O'Neil (RW/LW),Yale University,32,5,12,17,0.53,10,-10
354,Zach Metsa (D),Quinnipiac University,34,5,12,17,0.50,2,9
355,Chase Blackmun (D),UMass-Lowell,34,5,12,17,0.50,26,0
356,Parker Saretsky (F),Michigan Tech,36,5,12,17,0.47,6,-1
357,Luke Lynch (C),Robert Morris University,37,5,12,17,0.46,34,-8
358,Colton Poolman (D),University of North Dakota,31,4,13,17,0.55,4,15
359,Alex Berardinelli (C/LW),Colorado College,34,4,13,17,0.50,12,-7
360,Jerad Rosburg (D),Michigan State University,36,4,13,17,0.47,22,-5
361,Nick Bruce (F),RIT (Rochester Inst. of Tech.),34,3,14,17,0.50,22,2
362,Seamus Donohue (D),Michigan Tech,39,3,14,17,0.44,41,1
363,Michael Joyaux (D),Western Michigan University,36,2,15,17,0.47,27,3
364,Bryan Yoon (D),Colorado College,33,1,16,17,0.52,8,3
365,William Fällström (C/LW),Quinnipiac University,33,1,16,17,0.52,29,5
366,Zach Jordan (RW),University of Nebraska-Omaha,35,12,4,16,0.46,31,-1
367,Marshall Moise (F),Ferris State University,26,10,6,16,0.62,31,-5
368,Marshall Bowery (F),Air Force Academy,31,10,6,16,0.52,6,1
369,John Beecher (C/LW),University of Michigan,31,9,7,16,0.52,31,7
370,Jake Jaremko (LW/C),Minnesota State University (Mankato),24,8,8,16,0.67,12,10
371,Henry Bowlby (LW/C),Harvard University,31,8,8,16,0.52,18,5
372,Connor Sodergren (F),UMass-Lowell,31,8,8,16,0.52,37,4
373,Tanner Laderoute (RW/C),University of Minnesota-Duluth,31,8,8,16,0.52,40,15
374,Alex Green (D),Cornell University,29,7,9,16,0.55,33,20
375,Nick Wicks (F),University of Alaska-Anchorage,35,7,9,16,0.46,6,-19
376,Alex Peterson (F),College of the Holy Cross,36,7,9,16,0.44,37,-2
377,Will Cullen (D),Bowling Green State University,37,7,9,16,0.43,53,8
378,Kale Howarth (LW/C),University of Connecticut,29,6,10,16,0.55,16,2
379,Brett Gruber (C),Arizona State University,31,6,10,16,0.52,10,5
380,Hank Crone (RW/LW),University of Denver,31,6,10,16,0.52,10,5
381,Nate Kallen (D),Ferris State University,35,6,10,16,0.46,18,-24
382,Colton Leiter (D/C),University of Alaska-Fairbanks,35,6,10,16,0.46,36,5
383,Dylan Anhorn (D),Union College,37,6,10,16,0.43,22,3
384,Cam York (D),University of Michigan,30,5,11,16,0.53,10,9
385,Josh Passolt (LW),Western Michigan University,32,5,11,16,0.50,23,6
386,Matt Hellickson (D),University of Notre Dame,37,5,11,16,0.43,16,-12
387,Grant Meyer (RW),Canisius College,24,4,12,16,0.67,12,-4
388,Sam Malinski (D),Cornell University,25,4,12,16,0.64,12,14
389,Cory Babichuk (D),RPI (Rensselaer Polytech. Inst.),27,4,12,16,0.59,6,6
390,Jason Tackett (LW),Ferris State University,29,4,12,16,0.55,6,-14
391,Maxwell Crozier (D),Providence College,33,4,12,16,0.48,24,11
392,Nick Blankenburg (D),University of Michigan,35,4,12,16,0.46,14,3
393,Trevor Stone (C/LW),Air Force Academy,36,4,12,16,0.44,27,5
394,Domenick Fensore (D),Boston University,34,3,13,16,0.47,24,5
395,Jack St. Ivany (D),Yale University,32,1,15,16,0.50,18,-10
396,Dan Willett (D),RIT (Rochester Inst. of Tech.),35,0,16,16,0.46,29,-10
397,Andrew Rinaldi (LW),RIT (Rochester Inst. of Tech.),36,10,5,15,0.42,42,0
398,Filip Engarås (C/RW),University of New Hampshire,25,8,7,15,0.60,6,-4
399,Liam Grande (RW),Princeton University,29,8,7,15,0.52,4,-1
400,Eric Butte (F),Army (U.S. Military Academy),33,8,7,15,0.45,19,-5
401,Jacob Hayhurst (C/LW),University of Michigan,36,8,7,15,0.42,2,0
402,Quinn Olson (LW/C),University of Minnesota-Duluth,31,7,8,15,0.48,24,-2
403,Matt Pulver (F),Air Force Academy,34,7,8,15,0.44,14,-3
404,Zach Evancho (W),Army (U.S. Military Academy),22,6,9,15,0.68,24,5
405,Tristan Keck (LW),University of Nebraska-Omaha,23,6,9,15,0.65,6,8
406,Jeff Losurdo (F),Dartmouth College,30,6,9,15,0.50,31,-3
407,Janis Jaks (D),American International College,33,6,9,15,0.45,6,-1
408,Christian Rajic (C),University of Alabama-Huntsville,34,6,9,15,0.44,6,-28
409,Austin Albrecht (LW),American International College,33,5,10,15,0.45,10,0
410,Andrew Lucas (D),University of Vermont,34,5,10,15,0.44,24,4
411,Marc Del Gaizo (D),UMass,22,4,11,15,0.68,14,9
412,Jon McDonald (D),UMass-Lowell,25,4,11,15,0.60,10,7
413,Zach Giuttari (D),Brown University,31,4,11,15,0.48,10,-8
414,Nick Perbix (D),St. Cloud State University,34,4,11,15,0.44,25,-12
415,Brian Hurley (D),Clarkson University,28,3,12,15,0.54,12,7
416,Seth Barton (D),UMass-Lowell,30,3,12,15,0.50,20,2
417,Walker Duehr (RW),Minnesota State University (Mankato),32,3,12,15,0.47,33,16
418,Ryan Leibold (F),College of the Holy Cross,37,3,12,15,0.41,32,-7
419,Ben Newhouse (D),Northern Michigan University,38,3,12,15,0.39,4,-1
420,Tomi Hiekkavirta (D),University of Alaska-Anchorage,33,2,13,15,0.45,10,-21
421,Noah Delmas (D),Niagara University,34,1,14,15,0.44,12,1
422,Blake Evennou (D),Ferris State University,35,1,14,15,0.43,38,-14
423,Keenan Suthers (LW),St. Lawrence University,31,9,5,14,0.45,14,-6
424,Reed Lebster (RW),UMass,34,9,5,14,0.41,8,9
425,Alex Frye (C),University of Alaska-Anchorage,34,9,5,14,0.41,28,-13
426,Jared Pike (C),American International College,33,8,6,14,0.42,24,7
427,Alex Adams (F),Bemidji State University,35,8,6,14,0.40,19,15
428,Nikita Pavlychev (C),Penn State University,27,7,7,14,0.52,44,-3
429,Ryan Savage (RW),Miami University (Ohio),29,7,7,14,0.48,16,-9
430,Brent Beaudoin (C),Brown University,31,7,7,14,0.45,8,-8
431,Tanner Schachle (LW),University of Alaska-Anchorage,32,7,7,14,0.44,54,-2
432,Chase Pletzke (C),Miami University (Ohio),28,6,8,14,0.50,14,-5
433,Ronnie Attard (D),Western Michigan University,30,6,8,14,0.47,29,21
434,Jack Badini (C),Harvard University,31,6,8,14,0.45,10,5
435,Jaakko Heikkinen (F),University of Denver,32,6,8,14,0.44,4,2
436,Regan Kimens (LW),Merrimack College,33,6,8,14,0.42,14,-8
437,Colin O'Neill (F),UMass-Lowell,34,6,8,14,0.41,10,0
438,Sean Harrison (RW),Union College,36,6,8,14,0.39,6,-10
439,Sam Craggs (LW),Bowling Green State University,38,6,8,14,0.37,71,7
440,Sean Dhooghe (RW),University of Wisconsin,28,5,9,14,0.50,39,-6
441,Derek Topatigh (D),Princeton University,31,5,9,14,0.45,22,-4
442,Michael Zuffante (F),Bentley University,33,5,9,14,0.42,6,-3
443,Jami Krannila (C),St. Cloud State University,34,5,9,14,0.41,12,-4
444,Tristan Thompson (D),University of Alaska-Fairbanks,35,5,9,14,0.40,16,-6
445,Gordi Myer (D),Ohio State University,36,5,9,14,0.39,13,5
446,Jake Pappalardo (C),College of the Holy Cross,30,4,10,14,0.47,16,3
447,Ottoville Leppänen (F),RPI (Rensselaer Polytech. Inst.),33,4,10,14,0.42,2,-5
448,Tyler Nanne (D),University of Minnesota,35,4,10,14,0.40,2,7
449,Brett Orr (D),Bentley University,35,4,10,14,0.40,8,4
450,Mitchell Martan (LW),Canisius College,32,3,11,14,0.44,10,-2
451,Jacques Bouquot (C/LW),University of Vermont,33,3,11,14,0.42,12,-4
452,Jake McLaughlin (D),UMass,34,3,11,14,0.41,27,27
453,Austin Lemieux (RW),Arizona State University,35,3,11,14,0.40,26,1
454,Brandon Scanlin (D),University of Nebraska-Omaha,36,3,11,14,0.39,16,-4
455,Grant Loven (C),Northern Michigan University,38,3,11,14,0.37,20,-6
456,Mattias Samuelsson (D),Western Michigan University,30,2,12,14,0.47,41,17
457,John Keranen (F),Army (U.S. Military Academy),33,2,12,14,0.42,12,1
458,Alex Bates (D),Sacred Heart University,33,2,12,14,0.42,22,12
459,Josh McDougall (D),Mercyhurst University,36,2,12,14,0.39,4,-26
460,Yuki Miura (C/RW),Lake Superior State University,41,2,12,14,0.34,2,-5
461,Nick Rivera (C),Minnesota State University (Mankato),35,10,3,13,0.37,8,14
462,Justin Jallen (F),Brown University,31,9,4,13,0.42,4,-8
463,Tristan Ashbrook (C/RW),RPI (Rensselaer Polytech. Inst.),34,9,4,13,0.38,14,0
464,Matt DeMelis (F),Northeastern University,34,8,5,13,0.38,4,-3
465,Luke Voltin (D/C),Northern Michigan University,36,8,5,13,0.36,27,6
466,Trevor Janicke (RW/C),University of Notre Dame,37,8,5,13,0.35,6,1
467,Daniel Warpecha (LW),Dartmouth College,31,7,6,13,0.42,12,4
468,John Sladic (F),Miami University (Ohio),32,7,6,13,0.41,6,-18
469,Ace Cowans (C/LW),University of Vermont,34,7,6,13,0.38,26,-3
470,Kieran Durgan (F),Air Force Academy,24,6,7,13,0.54,4,-9
471,Jeff Malott (LW),Cornell University,29,6,7,13,0.45,12,16
472,Matt Quercia (C/LW),Boston University,29,6,7,13,0.45,14,-3
473,Austin Beaulieu (RW),University of Alabama-Huntsville,34,6,7,13,0.38,14,-16
474,Bradley Johnson (D),Bemidji State University,35,6,7,13,0.37,32,10
475,Jason O'Neill (F),Providence College,23,5,8,13,0.57,18,-3
476,Alex Esposito (RW),University of Vermont,30,5,8,13,0.43,14,-4
477,Monte Graham (F),Miami University (Ohio),34,5,8,13,0.38,24,-2
478,Josiah Slavin (LW/RW),Colorado College,34,5,8,13,0.38,43,-10
479,Jordan Steinmetz (F),St. Lawrence University,35,5,8,13,0.37,8,-23
480,Josh French (F),Minnesota State University (Mankato),37,5,8,13,0.35,0,8
481,Gueorgui Feduolov (F),Mercyhurst University,30,4,9,13,0.43,18,-12
482,Alexander Wilkinson (D),Army (U.S. Military Academy),33,4,9,13,0.39,0,-4
483,Skyler Brind'Amour (C/LW),Quinnipiac University,34,4,9,13,0.38,16,0
484,Aleksi Peltonen (F),St. Lawrence University,36,4,9,13,0.36,2,-17
485,Grant Gabriele (D),Ohio State University,36,4,9,13,0.36,4,-5
486,Tyler Kirkup (C/LW),Bemidji State University,36,4,9,13,0.36,16,6
487,Hank Sorensen (D),Northern Michigan University,37,4,9,13,0.35,101,1
488,Jack McNeely (D),Minnesota State University (Mankato),38,4,9,13,0.34,16,21
489,Jacob Levin (D),Air Force Academy,36,3,10,13,0.36,20,3
490,Jackson LaCombe (D),University of Minnesota,37,3,10,13,0.35,14,-1
491,Tory Dello (D),University of Notre Dame,37,3,10,13,0.35,24,1
492,Edwin Hookenson (D),Minnesota State University (Mankato),38,3,10,13,0.34,23,19
493,Tim Theocharidis (D),Bowling Green State University,38,3,10,13,0.34,35,1
494,Jimmy Lambert (RW/C),University of Michigan,32,2,11,13,0.41,6,6
495,Jake Wise (C/LW),Boston University,33,2,11,13,0.39,12,-2
496,Vasili Kolias (D),Union College,33,2,11,13,0.39,20,-15
497,Matt Lombardozzi (D),Bentley University,33,2,11,13,0.39,47,9
498,Jacob Nordqvist (D),Lake Superior State University,35,2,11,13,0.37,18,-13
499,Liam MacDougall (C/W),Ferris State University,35,2,11,13,0.37,18,-7
500,Dalton Skelly (D),College of the Holy Cross,36,2,11,13,0.36,10,-11
501,Rourke Russell (D),Miami University (Ohio),33,1,12,13,0.39,22,-16
502,Colin Felix (D),UMass,34,1,12,13,0.38,45,8
503,Max Harper (F),Air Force Academy,36,9,3,12,0.33,6,6
504,Jack Becker (C/RW),University of Michigan,32,8,4,12,0.38,23,6
505,Luke Manning (C/W),Air Force Academy,35,8,4,12,0.34,12,-9
506,Mac Welsher (C),Merrimack College,31,7,5,12,0.39,10,-18
507,Luke Stevens (LW),Yale University,31,7,5,12,0.39,25,-11
508,Marc Gatcomb (C/RW),University of Connecticut,34,7,5,12,0.35,18,1
509,Tommy Apap (C/LW),Michigan State University,36,7,5,12,0.33,8,-6
510,Bryce Brodzinski (RW),University of Minnesota,37,7,5,12,0.32,16,-3
511,Willie Reim (F),Air Force Academy,32,6,6,12,0.38,18,-3
512,Jack Jeffers (F),University of Alabama-Huntsville,33,6,6,12,0.36,37,-21
513,Brendon Michaelian (D),Robert Morris University,37,6,6,12,0.32,18,-4
514,Grant Hebert (C),Robert Morris University,17,5,7,12,0.71,25,5
515,Ryan Barrow (RW),University of Denver,27,5,7,12,0.44,8,2
516,Spencer Kersten (RW/LW),Princeton University,31,5,7,12,0.39,16,-10
517,Kevin Fitzgerald (C),St. Cloud State University,31,5,7,12,0.39,19,-4
518,Chase Brand (C),St. Cloud State University,31,5,7,12,0.39,27,-2
519,Nick Leivermann (D),University of Notre Dame,32,5,7,12,0.38,10,-1
520,Martin Sundberg (RW),University of Nebraska-Omaha,33,5,7,12,0.36,18,9
521,Marc McLaughlin (C/RW),Boston College,34,5,7,12,0.35,14,8
522,Graham McPhee (C/W),Boston College,34,5,7,12,0.35,42,4
523,Aidan Spellacy (F),Robert Morris University,37,5,7,12,0.32,22,-11
524,Judd Caulfield (RW/LW),University of North Dakota,29,4,8,12,0.41,7,13
525,Connor McMenamin (LW),Penn State University,32,4,8,12,0.38,2,-4
526,Filips Buncis (C),Arizona State University,32,4,8,12,0.38,10,8
527,Jake Wahlin (LW),St. Cloud State University,34,4,8,12,0.35,6,5
528,Connor Mayer (D),Colorado College,34,4,8,12,0.35,20,-1
529,Chris Harpur (D),Niagara University,34,4,8,12,0.35,30,-6
530,Wyatt Ege (D),Ohio State University,35,4,8,12,0.34,8,10
531,Luke Morgan (LW),University of Michigan,36,4,8,12,0.33,10,-1
532,Anthony Firriolo (D),Army (U.S. Military Academy),30,3,9,12,0.40,10,6
533,Sam Hesler (F),Dartmouth College,31,3,9,12,0.39,8,-5
534,Charles Levesque (C),UMass-Lowell,32,3,9,12,0.38,8,0
535,Hampus Sjödahl (LW),Bemidji State University,34,3,9,12,0.35,8,8
536,William Lemay (C/LW),University of Vermont,34,3,9,12,0.35,22,0
537,Joey Maziarz (D),Mercyhurst University,36,3,9,12,0.33,8,-17
538,Austin Pooley (C),Ohio State University,36,3,9,12,0.33,10,11
539,Darren Brady (D),RIT (Rochester Inst. of Tech.),36,3,9,12,0.33,16,-3
540,Zach Dubinsky (F),RPI (Rensselaer Polytech. Inst.),22,2,10,12,0.55,4,7
541,Luke Edgerton (F),Niagara University,29,2,10,12,0.41,12,-4
542,Travis Mitchell (D),Cornell University,29,2,10,12,0.41,29,20
543,Nolan Walker (C),St. Cloud State University,31,2,10,12,0.39,12,-24
544,Case McCarthy (D),Boston University,32,2,10,12,0.38,10,0
545,Harrison Blaisdell (C),University of North Dakota,32,2,10,12,0.38,16,10
546,Joe Rutkowski (D),Ferris State University,33,2,10,12,0.36,14,-15
547,Jeppe Urup Mogensen (D),Sacred Heart University,34,2,10,12,0.35,2,10
548,Dean Stewart (D),University of Nebraska-Omaha,34,2,10,12,0.35,26,-1
549,Lukas Kälble (D),Lake Superior State University,41,2,10,12,0.29,24,-11
550,Alex Mehnert (D),Air Force Academy,36,1,11,12,0.33,34,-1
551,Max Zimmer (LW),University of Wisconsin,21,8,3,11,0.52,2,-8
552,Zack Nazzarett (LW),University of Alaska-Anchorage,19,7,4,11,0.58,27,2
553,Nick Granowicz (C/RW),University of Michigan,21,7,4,11,0.52,6,4
554,Nick Jenny (D),Robert Morris University,27,7,4,11,0.41,10,0
555,Kobe Walker (RW),RIT (Rochester Inst. of Tech.),31,7,4,11,0.35,8,-1
556,Matt Kessel (D),UMass,34,7,4,11,0.32,48,13
557,R.J. Murphy (C),Harvard University,23,6,5,11,0.48,2,2
558,Christian Evers (D),University of Vermont,29,6,5,11,0.38,49,6
559,Brandon Stanley (F),Niagara University,33,6,5,11,0.33,47,6
560,Derek Lodermeier (LW),University of Vermont,34,6,5,11,0.32,16,-8
561,Marshall Warren (D),Boston College,34,6,5,11,0.32,22,22
562,Jonny Sorenson (F),University of Minnesota,35,6,5,11,0.31,10,1
563,Jake Transit (F),Ferris State University,35,6,5,11,0.31,48,-11
564,Niko Hildenbrand (F),UMass,31,5,6,11,0.35,12,14
565,Simon Kjellberg (D),RPI (Rensselaer Polytech. Inst.),32,5,6,11,0.34,30,2
566,John Picking (F),Northeastern University,34,5,6,11,0.32,10,-4
567,Jared Brandt (D),Niagara University,34,5,6,11,0.32,34,3
568,Mark Senden (C/LW),University of North Dakota,35,5,6,11,0.31,10,4
569,Tyson McLellan (C),University of Denver,36,5,6,11,0.31,30,2
570,Anthony Vincent (RW/C),College of the Holy Cross,21,4,7,11,0.52,20,0
571,Jonny Tychonick (D),University of North Dakota,24,4,7,11,0.46,14,20
572,David Jankowski (C/RW),St. Lawrence University,25,4,7,11,0.44,6,-15
573,Mark Paolini (D),Princeton University,27,4,7,11,0.41,14,-10
574,Bailey Conger (C/RW),Colorado College,27,4,7,11,0.41,14,1
575,Will Garin (RW),Bentley University,29,4,7,11,0.38,42,0
576,Jack Judson (D),Arizona State University,34,4,7,11,0.32,31,-1
577,Jacob Pivonka (C),University of Notre Dame,35,4,7,11,0.31,14,7
578,Zach Yoder (D),Ferris State University,35,4,7,11,0.31,48,-13
579,Matt Barry (F),Miami University (Ohio),17,3,8,11,0.65,18,-11
580,Jacob Wilson (D),Arizona State University,29,3,8,11,0.38,20,6
581,Jacob Paganelli (RW),Princeton University,30,3,8,11,0.37,6,-10
582,Collin Rutherford (C),Dartmouth College,30,3,8,11,0.37,10,-4
583,Nick Boyagian (F),Sacred Heart University,31,3,8,11,0.35,10,-5
584,Phil Kemp (D),Yale University,32,3,8,11,0.34,10,4
585,Liam Izyk (F),University of Alabama-Huntsville,32,3,8,11,0.34,12,-12
586,Phil Knies (LW/C),Miami University (Ohio),32,3,8,11,0.34,12,-11
587,Paul DeNaples (D),Penn State University,34,3,8,11,0.32,4,18
588,Connor MacEachern (C),Penn State University,34,3,8,11,0.32,18,-5
589,Chris McKay (D),RIT (Rochester Inst. of Tech.),35,3,8,11,0.31,49,17
590,Owen Norton (D),Mercyhurst University,36,3,8,11,0.31,48,-16
591,Riese Zmolek (D),Minnesota State University (Mankato),37,3,8,11,0.30,22,15
592,T.J. Lloyd (D),Bowling Green State University,38,3,8,11,0.29,12,3
593,Mathieu Gosselin (RW/LW),Clarkson University,33,2,9,11,0.33,25,8
594,Yan Kuznetsov (D),University of Connecticut,34,2,9,11,0.32,16,-7
595,Ty Farmer (D),UMass,34,2,9,11,0.32,24,15
596,Matt Alvaro (C/LW),University of Vermont,34,2,9,11,0.32,33,-13
597,Ryan Jones (D),University of Nebraska-Omaha,36,2,9,11,0.31,37,-6
598,Alexander Robert (D),Robert Morris University,36,2,9,11,0.31,39,-6
599,Justin Misiak (C),Michigan Tech,39,2,9,11,0.28,43,4
600,Brandon Schultz (C/LW),Northern Michigan University,18,1,10,11,0.61,8,4
601,Eric Ciccolini (RW),University of Michigan,26,1,10,11,0.42,6,-4
602,Luke Bafia (D),Western Michigan University,36,1,10,11,0.31,22,10
603,Trevor Cosgrove (D),Colgate University,35,0,11,11,0.31,10,6
604,Adam Tisdale (C),Clarkson University,26,8,2,10,0.38,8,4
605,Brett Abdelnour (LW),Army (U.S. Military Academy),32,7,3,10,0.31,12,-6
606,Justin Michaelian (F),Ferris State University,33,7,3,10,0.30,12,-16
607,Ethan Leyh (F),Quinnipiac University,34,7,3,10,0.29,8,-2
608,Matt Long (F),Canisius College,28,6,4,10,0.36,12,2
609,Patrick Shea (C),University of Maine,29,6,4,10,0.34,16,-4
610,Chaz Smedsrud (LW),Union College,33,6,4,10,0.30,8,-1
611,Anthony Romano (C/RW),Clarkson University,33,6,4,10,0.30,8,0
612,Dixon Bowen (C/RW),University of North Dakota,33,6,4,10,0.30,10,7
613,Ryan Garvey (LW),St. Lawrence University,33,6,4,10,0.30,14,-18
614,Ludwig Stenlund (C),Niagara University,16,5,5,10,0.63,12,-2
615,Christian O'Neill (C),Princeton University,22,5,5,10,0.45,25,-1
616,Matt Stienburg (C),Cornell University,27,5,5,10,0.37,45,12
617,Liam Walsh (LW),Merrimack College,30,5,5,10,0.33,43,-2
618,Bradley Cocca (C),Brown University,31,5,5,10,0.32,10,-10
619,Justin Kendall (F),Niagara University,31,5,5,10,0.32,14,-18
620,Ben Brar (LW),Merrimack College,32,5,5,10,0.31,15,-14
621,Brian Rigali (F),University of Connecticut,34,5,5,10,0.29,2,-6
622,Santeri Hartikainen (C/RW),Robert Morris University,34,5,5,10,0.29,4,-9
623,Matt Koopman (C/LW),Providence College,34,5,5,10,0.29,12,11
624,Bryce Misley (C),University of Vermont,34,5,5,10,0.29,14,-7
625,Tyler Penner (RW/C),Colgate University,34,5,5,10,0.29,20,-1
626,James LaDouce (D),University of Alaska-Fairbanks,35,5,5,10,0.29,26,-1
627,Jake Durflinger (RW/C),University of Denver,35,5,5,10,0.29,46,1
628,Lawton Courtnall (LW),Western Michigan University,36,5,5,10,0.28,18,4
629,Graham Slaggert (C/LW),University of Notre Dame,37,5,5,10,0.27,8,-5
630,Casey Linkenheld (LW),Bowling Green State University,38,5,5,10,0.26,4,-7
631,Chase Stevenson (F),University of New Hampshire,24,4,6,10,0.42,10,-3
632,Griffin Lunn (F),Colgate University,31,4,6,10,0.32,29,4
633,Eric Esposito (LW),University of New Hampshire,33,4,6,10,0.30,12,2
634,Ryan Smith (C/RW),University of Maine,34,4,6,10,0.29,8,0
635,Spencer Meier (D),St. Cloud State University,34,4,6,10,0.29,8,-2
636,Lucas Condotta (C),UMass-Lowell,34,4,6,10,0.29,14,-3
637,Jack Summers (D),University of Michigan,36,4,6,10,0.28,16,7
638,Tarek Baker (LW),University of Wisconsin,36,4,6,10,0.28,26,-11
639,Patrick Holway (D),Merrimack College,17,3,7,10,0.59,10,-6
640,Evan Wisocky (C),Sacred Heart University,20,3,7,10,0.50,14,4
641,Jayden Struble (D),Northeastern University,21,3,7,10,0.48,36,-2
642,Kyle Betts (C),Cornell University,24,3,7,10,0.42,6,5
643,Tanner Hickey (D),University of Alabama-Huntsville,30,3,7,10,0.33,30,-28
644,Benton Maass (D),University of New Hampshire,34,3,7,10,0.29,8,6
645,Matt Slick (D),College of the Holy Cross,34,3,7,10,0.29,22,3
646,Garrett Van Wyhe (C),University of Michigan,36,3,7,10,0.28,35,3
647,Gavin Hain (C/LW),University of North Dakota,28,2,8,10,0.36,13,3
648,Todd Goehring (F),Sacred Heart University,30,2,8,10,0.33,19,5
649,Ethan Phillips (C/RW),Boston University,31,2,8,10,0.32,8,-2
650,Carter Berger (D),University of Connecticut,31,2,8,10,0.32,14,4
651,Taylor Lantz (C),University of Alaska-Anchorage,31,2,8,10,0.32,26,-3
652,Jake Stevens (D),St. Lawrence University,33,2,8,10,0.30,22,-21
653,Jared Nash (C),University of Alaska-Anchorage,33,2,8,10,0.30,38,-8
654,Kris Myllari (D),Penn State University,34,2,8,10,0.29,10,0
655,Veli-Matti Tiuraniemi (D),University of Maine,34,2,8,10,0.29,10,-6
656,Luke McInnis (D),Boston College,34,2,8,10,0.29,41,12
657,Tony Stillwell (D),Brown University,23,1,9,10,0.43,8,-5
658,Brendan Demler (D),Dartmouth College,31,1,9,10,0.32,17,1
659,Thomas Farrell (D),Army (U.S. Military Academy),32,1,9,10,0.31,8,3
660,J.D. Greenway (F/D),University of Maine,34,1,9,10,0.29,61,5
661,Andrew Peski (D),University of North Dakota,35,1,9,10,0.29,12,17
662,Nick Austin (D),Colgate University,22,0,10,10,0.45,22,4
663,Nick Wolff (D),University of Minnesota-Duluth,33,0,10,10,0.30,42,18
664,Jake Joffe (RW),RIT (Rochester Inst. of Tech.),24,7,2,9,0.38,6,7
665,Zachary Okabe (RW),St. Cloud State University,30,7,2,9,0.30,10,-6
666,Jason Polin (RW),Western Michigan University,31,7,2,9,0.29,8,6
667,Colin Saccoman (D),Lake Superior State University,17,6,3,9,0.53,23,-4
668,Cal Kiefiuk (F),UMass,30,6,3,9,0.30,10,4
669,John Snodgrass (C),Colgate University,35,6,3,9,0.26,4,-5
670,Arnaud Vachon (C),Colgate University,36,6,3,9,0.25,18,-6
671,Daneel Lategan (F),University of Alabama-Huntsville,30,5,4,9,0.30,18,-5
672,Zachary Emelifeonwu (LW),Union College,35,5,4,9,0.26,61,-5
673,Trey deGraaf (F),University of Alaska-Anchorage,36,5,4,9,0.25,10,-11
674,Mark Gallant (F),Dartmouth College,26,4,5,9,0.35,6,-9
675,Cameron Crotty (D),Boston University,30,4,5,9,0.30,26,-1
676,Paul Maust (LW),Mercyhurst University,30,4,5,9,0.30,45,-13
677,Luke Krys (D),Brown University,31,4,5,9,0.29,26,-17
678,Jack Clement (D),Miami University (Ohio),33,4,5,9,0.27,20,-5
679,Vladislav Dzhioshvili (C),University of Vermont,33,4,5,9,0.27,69,-2
680,Logan Ganie (LW),Michigan Tech,34,4,5,9,0.26,8,5
681,A.J. Drobot (RW),University of Maine,34,4,5,9,0.26,14,-1
682,Troy Conzo (F),Colorado College,23,3,6,9,0.39,6,-6
683,Jonathan Bendorf (LW),Mercyhurst University,24,3,6,9,0.38,2,-16
684,Matthew Thom (D),Princeton University,27,3,6,9,0.33,14,-16
685,Michael Pastujov (LW),University of Michigan,29,3,6,9,0.31,12,-1
686,Dylan Pitera (F),Bentley University,31,3,6,9,0.29,16,5
687,Daniel Haider (F),Army (U.S. Military Academy),33,3,6,9,0.27,4,-3
688,Chris Dodero (C/LW),American International College,34,3,6,9,0.26,12,3
689,Griffin Mendel (D),University of Denver,36,3,6,9,0.25,10,13
690,Will Brophy (D),College of the Holy Cross,37,3,6,9,0.24,10,-8
691,Brandon Estes (D),Union College,37,3,6,9,0.24,26,-8
692,A.J. Vanderbeck (RW),Northern Michigan University,8,2,7,9,1.13,2,8
693,Noah Bauld (C),Cornell University,26,2,7,9,0.35,29,3
694,Clayton Phillips (D),Penn State University,27,2,7,9,0.33,20,-2
695,Evan Smith (C/LW),Yale University,28,2,7,9,0.32,14,-11
696,Jake Flynn (D),University of Connecticut,30,2,7,9,0.30,8,0
697,Jeremy Germain (C/LW),Princeton University,31,2,7,9,0.29,4,-6
698,Michael Maloney (F),Brown University,31,2,7,9,0.29,25,-17
699,Nick Lalonde (RW),Robert Morris University,32,2,7,9,0.28,12,-2
700,Andy Carroll (D),Minnesota State University (Mankato),33,2,7,9,0.27,6,18
701,Connor Moore (D),Boston College,33,2,7,9,0.27,12,9
702,Jade Miller (LW),University of Minnesota-Duluth,34,2,7,9,0.26,6,9
703,Jesper Mattila (D),Boston College,34,2,7,9,0.26,10,30
704,Stanislav Demin (D),University of Denver,34,2,7,9,0.26,50,4
705,Alex Gilmour (LW),St. Lawrence University,35,2,7,9,0.26,16,-8
706,Roberts Kalkis (D),University of Alaska-Fairbanks,35,2,7,9,0.26,18,-2
707,Tommy Miller (D),Michigan State University,36,2,7,9,0.25,4,4
708,Jacob Semik (D),Arizona State University,36,2,7,9,0.25,25,0
709,Dustin Manz (C/RW),Lake Superior State University,40,2,7,9,0.23,18,-13
710,Brendan Less (D),Dartmouth College,31,1,8,9,0.29,10,8
711,Dakota Raabe (LW),University of Michigan,32,1,8,9,0.28,10,4
712,Ty Emberson (D),University of Wisconsin,33,1,8,9,0.27,53,-9
713,Harrison Rees (D),University of Connecticut,34,1,8,9,0.26,18,0
714,Jakub Sirota (D),University of Maine,34,1,8,9,0.26,26,10
715,Jack Surowiec (C/LW),College of the Holy Cross,34,1,8,9,0.26,33,-14
716,Kyle Marino (C/D),University of Alaska-Fairbanks,35,1,8,9,0.26,76,-3
717,Ryan Nicholson (D),RIT (Rochester Inst. of Tech.),36,1,8,9,0.25,16,10
718,Luke Martin (D),University of Michigan,36,1,8,9,0.25,18,10
719,Ryan Zuhlsdorf (D),University of Minnesota,37,1,8,9,0.24,8,5
720,Tyler Rockwell (D),Michigan Tech,38,1,8,9,0.24,10,4
721,Bryson Traptow (F),RIT (Rochester Inst. of Tech.),17,0,9,9,0.53,19,2
722,Nate Clurman (D),University of Notre Dame,37,0,9,9,0.24,10,8
723,Coale Norris (LW),Ferris State University,25,6,2,8,0.32,29,-17
724,Raymond Brice (C/LW),Michigan Tech,28,6,2,8,0.29,6,-1
725,Cam Strong (LW),Dartmouth College,31,6,2,8,0.26,12,-6
726,Tyr Thompson (C),University of Alabama-Huntsville,32,6,2,8,0.25,18,-10
727,Chris Schutz (LW/RW),UMass-Lowell,23,5,3,8,0.35,2,4
728,Dante Palecco (LW),Yale University,28,5,3,8,0.29,6,-8
729,Sam Rennaker (C),University of Maine,28,5,3,8,0.29,14,1
730,Kaden Pickering (RW),St. Lawrence University,28,5,3,8,0.29,29,-15
731,Christopher Klack (C/W),Clarkson University,29,5,3,8,0.28,4,4
732,Zach Kaiser (C/LW),UMass-Lowell,30,5,3,8,0.27,31,4
733,Koby Bender (RW/C),University of Minnesota-Duluth,32,5,3,8,0.25,16,1
734,Andrew McIntyre (RW),St. Lawrence University,26,4,4,8,0.31,14,0
735,Khristian Acosta (F),Mercyhurst University,26,4,4,8,0.31,68,-15
736,Jason Smallidge (D),University of Nebraska-Omaha,27,4,4,8,0.30,14,5
737,Christian Sanda (F),Union College,32,4,4,8,0.25,4,-9
738,Anthony Callin (RW/D),Clarkson University,34,4,4,8,0.24,27,4
739,Mitchel Slattery (RW),Northern Michigan University,36,4,4,8,0.22,10,-16
740,Garrett Klee (F),Northern Michigan University,37,4,4,8,0.22,35,-4
741,Brayden Camrud (C),University of Alaska-Anchorage,21,3,5,8,0.38,62,-3
742,Brett Van Os (LW),Western Michigan University,22,3,5,8,0.36,6,2
743,Brayden Gelsinger (LW),Lake Superior State University,22,3,5,8,0.36,16,2
744,Caleb Schroer (F),Northern Michigan University,25,3,5,8,0.32,4,1
745,Demetrios Koumontzis (LW/D),Arizona State University,25,3,5,8,0.32,21,-9
746,Ashton Fry (F),St. Lawrence University,26,3,5,8,0.31,12,0
747,Liam Robertson (C),Union College,27,3,5,8,0.30,26,-2
748,Connor Merkley (C),University of Alabama-Huntsville,29,3,5,8,0.28,25,-17
749,Miroslav Mucha (RW),Lake Superior State University,30,3,5,8,0.27,20,-5
750,Colton Kerfoot (F),Harvard University,31,3,5,8,0.26,6,1
751,Ryan Siedem (D),Harvard University,31,3,5,8,0.26,8,7
752,Kale Bennett (D),Western Michigan University,33,3,5,8,0.24,8,6
753,Ben Poisson (F),University of Maine,34,3,5,8,0.24,14,1
754,Josh Nodler (C/RW),Michigan State University,36,3,5,8,0.22,2,-1
755,Nicolas Müller (C/RW),Michigan State University,36,3,5,8,0.22,10,1
756,Adam Roeder (D),Northern Michigan University,36,3,5,8,0.22,12,-1
757,Jacob Panetta (D),Colgate University,36,3,5,8,0.22,12,-1
758,Brody Stevens (C),Michigan State University,36,3,5,8,0.22,30,-3
759,James Crossman (D),Brown University,21,2,6,8,0.38,18,3
760,Jack Malone (RW/C),Cornell University,27,2,6,8,0.30,4,11
761,Nick Campoli (C),Clarkson University,29,2,6,8,0.28,16,-2
762,Charlie Marchand (D),Bentley University,30,2,6,8,0.27,10,6
763,Max Luukko (D),Sacred Heart University,31,2,6,8,0.26,10,5
764,Anthony Del Gaizo (LW/C),UMass,31,2,6,8,0.26,29,9
765,Lucas Vanroboys (C/RW),Bentley University,32,2,6,8,0.25,18,4
766,Parker Revering (D),American International College,32,2,6,8,0.25,28,8
767,Brady Ferner (D),RPI (Rensselaer Polytech. Inst.),34,2,6,8,0.24,8,-4
768,Gianluca Esteves (F),Michigan State University,35,2,6,8,0.23,2,1
769,Robbie Stucker (D),University of Minnesota,35,2,6,8,0.23,4,-2
770,Joshua Ess (D),University of Wisconsin,35,2,6,8,0.23,4,-3
771,Jarrod Gourley (D),Arizona State University,35,2,6,8,0.23,29,5
772,Eric Sinclair (D),University of Alaska-Anchorage,36,2,6,8,0.22,54,-11
773,Tyler Vold (D),Bemidji State University,37,2,6,8,0.22,4,9
774,Reid Stefanson (C/LW),UMass-Lowell,14,1,7,8,0.57,4,-5
775,Bray Crowder (D),Miami University (Ohio),27,1,7,8,0.30,31,-4
776,Nicolas Luka (D),American International College,30,1,7,8,0.27,14,10
777,Marshall Rifai (D),Harvard University,30,1,7,8,0.27,20,6
778,Graham Lillibridge (D),Yale University,32,1,7,8,0.25,4,-3
779,Zach Vinnell (D/LW),Merrimack College,33,1,7,8,0.24,18,-14
780,Keaton Pehrson (D),University of Michigan,35,1,7,8,0.23,0,10
781,Mike Van Unen (D),Northern Michigan University,36,1,7,8,0.22,41,3
782,Logan Gestro (D),Canisius College,28,0,8,8,0.29,16,-1
783,Billy Sweezey (D),Yale University,32,0,8,8,0.25,47,-3
784,Mitchell Oliver (D),Lake Superior State University,34,0,8,8,0.24,18,0
785,Kasper Kotkansalo (D),Boston University,34,0,8,8,0.24,23,-2
786,Ryan Johnson (D),University of Minnesota,37,0,8,8,0.22,20,-9
787,Wilmer Skoog (C),Boston University,17,5,2,7,0.41,20,1
788,Brendan Walkom (C/LW),Bentley University,25,5,2,7,0.28,2,5
789,Gabriel Chabot (RW/D),Boston University,33,5,2,7,0.21,17,1
790,Ryan Miotto (F),Canisius College,34,5,2,7,0.21,18,-13
791,Jaedon Leslie (F),Ohio State University,15,4,3,7,0.47,0,6
792,Sam Knoblauch (RW),UMass-Lowell,16,4,3,7,0.44,4,3
793,Ross Armour (C/RW),Bemidji State University,26,4,3,7,0.27,8,3
794,Dallas Tulik (F),Ferris State University,26,4,3,7,0.27,16,-5
795,Cole Quisenberry (F),Brown University,28,4,3,7,0.25,12,0
796,Brett Edwards (F),University of Denver,28,4,3,7,0.25,16,-8
797,Connor Wood (RW),University of Alabama-Huntsville,30,4,3,7,0.23,32,-7
798,Finn Evans (RW),Princeton University,31,4,3,7,0.23,18,-4
799,Geoff Kitt (C),Mercyhurst University,32,4,3,7,0.22,14,-21
800,Biagio Lerario (C),Northeastern University,32,4,3,7,0.22,74,-7
801,Blake Bride (RW),Air Force Academy,33,4,3,7,0.21,10,-9
802,Brendan McKay (LW),Lake Superior State University,41,4,3,7,0.17,19,-5
803,Joe Leahy (D),Cornell University,10,3,4,7,0.70,4,10
804,Parker Foo (LW),Union College,20,3,4,7,0.35,10,-4
805,Christiano Versich (RW),Colorado College,29,3,4,7,0.24,10,-7
806,Mitchell Smith (LW),Yale University,30,3,4,7,0.23,12,-10
807,Jack Gates (C),Colorado College,31,3,4,7,0.23,6,2
808,Will D'Orsi (C),Yale University,31,3,4,7,0.23,12,-7
809,Zac Robbins (F),University of Connecticut,33,3,4,7,0.21,2,-3
810,Nolan Moyle (C/RW),University of Michigan,33,3,4,7,0.21,8,0
811,Josh McKechney (F),Colgate University,35,3,4,7,0.20,16,-8
812,Austen Long (RW/C),American International College,14,2,5,7,0.50,2,3
813,Michael Gilroy (D),Sacred Heart University,19,2,5,7,0.37,4,2
814,Garrett Wait (LW),University of Minnesota,21,2,5,7,0.33,0,1
815,Kevin Wall (RW),Penn State University,26,2,5,7,0.27,8,1
816,Jack Gorniak (LW/C),University of Wisconsin,28,2,5,7,0.25,8,-7
817,Matthew Allen (C),Union College,28,2,5,7,0.25,12,1
818,Carter Jones (F),Bemidji State University,30,2,5,7,0.23,2,5
819,Trey Dodd (F),Brown University,30,2,5,7,0.23,4,0
820,Hunter Wendt (F),Ferris State University,31,2,5,7,0.23,23,-11
821,Jeff Baum (D),American International College,32,2,5,7,0.22,14,4
822,Greyson Reitmeier (LW/C),Michigan Tech,33,2,5,7,0.21,6,-9
823,Adrien Bisson (D),University of Maine,33,2,5,7,0.21,29,2
824,Jonathan Lazarus (RW),Mercyhurst University,34,2,5,7,0.21,4,-19
825,Zach Berzolla (D),Colorado College,34,2,5,7,0.21,62,-7
826,Jack Perbix (RW/D),University of Minnesota,35,2,5,7,0.20,16,-5
827,Tyler Inamoto (D),University of Wisconsin,35,2,5,7,0.20,16,-9
828,Jagger Joshua (LW/RW),Michigan State University,36,2,5,7,0.19,35,0
829,Josh Kosack (RW),Union College,37,2,5,7,0.19,12,-6
830,Emil Westerlund (LW/RW),University of Maine,18,1,6,7,0.39,12,2
831,Patrick Dawson (D),Sacred Heart University,21,1,6,7,0.33,10,6
832,Shawn Knowlton (F),Air Force Academy,24,1,6,7,0.29,2,-2
833,Evan Bell (D),Penn State University,25,1,6,7,0.28,8,10
834,Cam Clarke (D),Ferris State University,27,1,6,7,0.26,4,-10
835,Jake Stella (LW),American International College,27,1,6,7,0.26,8,-1
836,Eriks Zohovs (C),University of Alaska-Fairbanks,27,1,6,7,0.26,8,-9
837,Ryan O'Connell (D),Ohio State University,29,1,6,7,0.24,6,0
838,Dominic Dockery (D),Merrimack College,29,1,6,7,0.24,8,-15
839,Dustyn McFaul (D),Clarkson University,31,1,6,7,0.23,14,7
840,Kirby Proctor (D),University of Nebraska-Omaha,32,1,6,7,0.22,12,9
841,Greg Moro (D),Clarkson University,32,1,6,7,0.22,20,2
842,Dayne Finnson (D),University of Alabama-Huntsville,32,1,6,7,0.22,21,-20
843,Cody Fleckenstein (D),Army (U.S. Military Academy),33,1,6,7,0.21,16,5
844,Anthony Wyse (D),University of New Hampshire,33,1,6,7,0.21,51,7
845,Ty Pochipinski (F),Air Force Academy,36,1,6,7,0.19,10,1
846,Nate Knoepke (D),University of Nebraska-Omaha,36,1,6,7,0.19,16,4
847,Jesse Lansdell (LW),University of Notre Dame,37,1,6,7,0.19,37,-2
848,John DeRoche (D/F),University of Vermont,28,0,7,7,0.25,2,-6
849,Joey Matthews (D),Dartmouth College,29,0,7,7,0.24,19,-1
850,Hudson Lambert (D),Canisius College,30,0,7,7,0.23,23,-7
851,Ethan Johnson (F),Mercyhurst University,32,0,7,7,0.22,29,-14
852,Jordan Schneider (D),Clarkson University,34,0,7,7,0.21,43,5
853,Nick Hale (D),College of the Holy Cross,35,0,7,7,0.20,16,-6
854,Dylan Woolf (D),St. Lawrence University,36,0,7,7,0.19,51,-18
855,Will Zmolek (D),Bemidji State University,37,0,7,7,0.19,20,-1
856,Luke Loheit (RW),University of Minnesota-Duluth,33,5,1,6,0.18,8,-5
857,Austin Wong (RW/C),Harvard University,21,4,2,6,0.29,18,-1
858,Adam Conquest (RW),Bowling Green State University,23,4,2,6,0.26,4,3
859,Justin Cmunt (LW),Mercyhurst University,27,4,2,6,0.22,8,-20
860,Ron Greco (F),Boston College,27,4,2,6,0.22,23,4
861,Grant Cooper (LW),Clarkson University,33,4,2,6,0.18,8,-4
862,Vimal Sukumaran (RW),Providence College,33,4,2,6,0.18,32,1
863,Evan Dougherty (RW),Bowling Green State University,33,4,2,6,0.18,45,4
864,Michael Coyne (F),Robert Morris University,36,4,2,6,0.17,35,4
865,Jordan Seyfert (C),Merrimack College,16,3,3,6,0.38,10,-3
866,Sam Stevens (C/LW),Boston University,20,3,3,6,0.30,14,-1
867,Baker Shore (RW),Harvard University,30,3,3,6,0.20,20,6
868,Nathan Krusko (C),Harvard University,31,3,3,6,0.19,14,-4
869,Roman Kraemer (F),Robert Morris University,31,3,3,6,0.19,16,-3
870,Tyler Gratton (RW),Penn State University,31,3,3,6,0.19,24,-5
871,Nathan Burke (C/LW),University of Minnesota,32,3,3,6,0.19,2,-9
872,Justin Howell (C),University of Connecticut,32,3,3,6,0.19,33,-5
873,Luke Johnson (D),Providence College,33,3,3,6,0.18,2,7
874,Anthony Baxter (D),UMass-Lowell,33,3,3,6,0.18,38,4
875,Cam McDonald (D),Providence College,34,3,3,6,0.18,18,0
876,Alex Ambrosio (F),Lake Superior State University,34,3,3,6,0.18,33,-11
877,Cole Krygier (D),Michigan State University,36,3,3,6,0.17,20,0
878,Noah Jordan (RW),Miami University (Ohio),15,2,4,6,0.40,0,1
879,Cameron Cook (F),Niagara University,18,2,4,6,0.33,10,2
880,Tristan Crozier (F),Brown University,19,2,4,6,0.32,16,-11
881,Luke Rowe (D),Air Force Academy,22,2,4,6,0.27,27,1
882,Justin Cole (F),American International College,24,2,4,6,0.25,0,-1
883,Joachim Weberg (LW),Brown University,24,2,4,6,0.25,2,4
884,Tyler Jeanson (C),Colgate University,25,2,4,6,0.24,4,0
885,Thomas Beretta (C),University of Vermont,31,2,4,6,0.19,14,-10
886,Justin Lee (D),University of Denver,31,2,4,6,0.19,22,2
887,Jaxon Nelson (C/RW),University of Minnesota,33,2,4,6,0.18,2,-7
888,Brendan van Riemsdyk (C),Northeastern University,33,2,4,6,0.18,27,-4
889,Shane Kavanagh (F),Providence College,34,2,4,6,0.18,12,-11
890,Max Kaufman (F),University of Vermont,34,2,4,6,0.18,12,-10
891,Ryan Verrier (D),University of New Hampshire,34,2,4,6,0.18,37,-3
892,Didrik Henbrant (RW/C),University of Alaska-Fairbanks,36,2,4,6,0.17,16,-3
893,Zach Court (LW),University of Alaska-Anchorage,23,1,5,6,0.26,10,-12
894,Kip Hoffmann (F),Robert Morris University,23,1,5,6,0.26,10,1
895,Pito Walton (D),Princeton University,25,1,5,6,0.24,6,-16
896,Brian Chambers (RW),UMass-Lowell,25,1,5,6,0.24,6,-3
897,Matthew Verboon (RW/C),Colgate University,25,1,5,6,0.24,8,-6
898,Shane Kuzmeski (D),Clarkson University,26,1,5,6,0.23,12,3
899,Jack Zielinski (D),Niagara University,27,1,5,6,0.22,8,7
900,Drew Helleson (D),Boston College,28,1,5,6,0.21,12,12
901,Kyle Stephan (RW),American International College,28,1,5,6,0.21,12,-4
902,Ryan Cox (F),Niagara University,29,1,5,6,0.21,29,0
903,Liam Gorman (C),Princeton University,31,1,5,6,0.19,18,-14
904,Michael Higgins (D),College of the Holy Cross,32,1,5,6,0.19,10,0
905,Antti Virtanen (D),University of Alaska-Fairbanks,33,1,5,6,0.18,22,0
906,Adam Pitters (F),Bowling Green State University,34,1,5,6,0.18,28,5
907,Paul Meyer (D),Colgate University,36,1,5,6,0.17,12,-10
908,Sean Giles (D),Robert Morris University,37,1,5,6,0.16,28,0
909,Matt Staudacher (D),University of Minnesota,37,1,5,6,0.16,29,5
910,Julian Kislin (D),Northeastern University,23,0,6,6,0.26,14,-5
911,Ondrej Trejbal (D),St. Cloud State University,28,0,6,6,0.21,16,0
912,P.J. Fletcher (C/RW),Quinnipiac University,30,0,6,6,0.20,2,-4
913,Bauer Neudecker (F),University of Alabama-Huntsville,31,0,6,6,0.19,10,-24
914,Jake Johnson (D),RPI (Rensselaer Polytech. Inst.),32,0,6,6,0.19,26,2
915,Kalle Eriksson (D),University of New Hampshire,33,0,6,6,0.18,8,-5
916,Connor James (D),University of Alabama-Huntsville,33,0,6,6,0.18,20,-20
917,Caleb Hite (F),University of Alaska-Fairbanks,24,4,1,5,0.21,14,-4
918,Michael Lombardi (C/LW),Quinnipiac University,28,4,1,5,0.18,4,2
919,Lucas Jaycox (D),St. Cloud State University,34,4,1,5,0.15,10,-4
920,Brendan Soucie (F),Army (U.S. Military Academy),10,3,2,5,0.50,0,-9
921,Simon Gravel (C/RW),Canisius College,10,3,2,5,0.50,2,-3
922,Patrick Giles (C/RW),Boston College,10,3,2,5,0.50,4,6
923,Alex Truscott (F),Niagara University,20,3,2,5,0.25,8,1
924,Carver Watson (D),Mercyhurst University,22,3,2,5,0.23,2,-11
925,Ryan Kruper (F),RIT (Rochester Inst. of Tech.),26,3,2,5,0.19,12,4
926,Ryan Cook (D),Niagara University,26,3,2,5,0.19,48,4
927,Joe O'Connor (D),Quinnipiac University,27,3,2,5,0.19,20,-3
928,Tyler Campbell (C),Dartmouth College,29,3,2,5,0.17,2,-12
929,Andrew Gaus (RW),Colorado College,29,3,2,5,0.17,18,-1
930,Brenden MacLaren (F),Ferris State University,29,3,2,5,0.17,31,-3
931,Josh Boyer (C),University of Nebraska-Omaha,31,3,2,5,0.16,14,3
932,Brandon Salerno (C),University of Alabama-Huntsville,32,3,2,5,0.16,2,-17
933,Darcy Walsh (C),Robert Morris University,32,3,2,5,0.16,10,-9
934,Billy Jerry (C/RW),RPI (Rensselaer Polytech. Inst.),33,3,2,5,0.15,8,-4
935,Will MacKinnon (D),University of New Hampshire,34,3,2,5,0.15,16,-8
936,Logan Cockerill (LW/RW),Boston University,18,2,3,5,0.28,12,-5
937,Blake Wareham (D),Canisius College,19,2,3,5,0.26,2,-1
938,T.J. Walsh (LW),Northeastern University,20,2,3,5,0.25,6,-1
939,Gabe Bast (D),University of North Dakota,22,2,3,5,0.23,18,1
940,Cole Donhauser (C/W),Yale University,23,2,3,5,0.22,10,-5
941,Michael Ufberg (D),Princeton University,25,2,3,5,0.20,6,-4
942,Mason Snell (D),Penn State University,26,2,3,5,0.19,6,-10
943,Guus van Nes (LW/RW),Quinnipiac University,27,2,3,5,0.19,6,-8
944,Garrett Clegg (RW),Robert Morris University,27,2,3,5,0.19,16,-2
945,Keegan Ford (D),Michigan Tech,27,2,3,5,0.19,21,11
946,Colin Burston (LW),Brown University,31,2,3,5,0.16,29,-14
947,Ryder Donovan (C/RW),University of Wisconsin,32,2,3,5,0.16,24,-8
948,Marek Korencik (D),UMass-Lowell,33,2,3,5,0.15,8,3
949,Owen Farris (C),Union College,33,2,3,5,0.15,21,-10
950,Tyler Drevitch (C),Merrimack College,34,2,3,5,0.15,16,-10
951,Louie Roehl (D),University of Minnesota-Duluth,34,2,3,5,0.15,24,8
952,Michael Kesselring (D),Northeastern University,34,2,3,5,0.15,35,-2
953,Butrus Ghafari (D),Michigan State University,36,2,3,5,0.14,24,-1
954,Jackson Keane (C),University of North Dakota,19,1,4,5,0.26,0,-3
955,Jake Gaudet (C),UMass,19,1,4,5,0.26,14,2
956,Henry Marshall (F),Colgate University,20,1,4,5,0.25,0,5
957,Kristian Blumenschein (D),Colorado College,21,1,4,5,0.24,10,-11
958,Jordan Peacock (F),RIT (Rochester Inst. of Tech.),21,1,4,5,0.24,29,1
959,Andrew Petrucci (C),RIT (Rochester Inst. of Tech.),22,1,4,5,0.23,10,1
960,Jacob Dalton (D),Bowling Green State University,26,1,4,5,0.19,12,1
961,Sam Renlund (F),Colorado College,26,1,4,5,0.19,32,4
962,Matthew Berkovitz (D),Army (U.S. Military Academy),27,1,4,5,0.19,6,-9
963,Philip Lagunov (C),UMass,27,1,4,5,0.19,10,9
964,Marcus Walter (D),Bentley University,28,1,4,5,0.18,14,0
965,David Melaragni (D),Canisius College,28,1,4,5,0.18,31,-9
966,Cameron Buhl (F),St. Lawrence University,29,1,4,5,0.17,12,-9
967,Jérémie Bucheler (D),Northeastern University,29,1,4,5,0.17,22,0
968,Zac Herrmann (D),Niagara University,30,1,4,5,0.17,4,0
969,Regan Seiferling (D),RIT (Rochester Inst. of Tech.),30,1,4,5,0.17,8,4
970,Miguel Fidler (LW),Ohio State University,30,1,4,5,0.17,10,-11
971,Ethan Frisch (D),University of North Dakota,31,1,4,5,0.16,17,9
972,Connor Fedorek (D),Ferris State University,31,1,4,5,0.16,20,-8
973,Liam Dennison (D),Merrimack College,31,1,4,5,0.16,23,-17
974,Jared Kucharek (D),Western Michigan University,32,1,4,5,0.16,10,5
975,Mike Vorlicky (D),University of Wisconsin,32,1,4,5,0.16,12,-1
976,Colin Schmidt (C),Union College,32,1,4,5,0.16,18,-9
977,Brendan Riley (C),Mercyhurst University,32,1,4,5,0.16,42,-15
978,Neil Shea (LW),Northeastern University,33,1,4,5,0.15,14,-7
979,Luke Orysiuk (D),Bentley University,33,1,4,5,0.15,43,-6
980,Carson Musser (D),Bowling Green State University,34,1,4,5,0.15,10,-8
981,Zac Masson (RW),University of Alaska-Anchorage,34,1,4,5,0.15,18,-12
982,Michael Davies (D),University of Denver,34,1,4,5,0.15,20,9
983,Tim Makowski (D),St. Lawrence University,34,1,4,5,0.15,22,-9
984,Simon Butala (D),University of Maine,34,1,4,5,0.15,52,6
985,Kyle Mayhew (D),University of Denver,36,1,4,5,0.14,20,15
986,Justin Wells (D),Bowling Green State University,38,1,4,5,0.13,10,-4
987,Tyler Anderson (D),Lake Superior State University,40,1,4,5,0.13,24,-6
988,Albin Nilsson (C),Providence College,22,0,5,5,0.23,8,-1
989,Zach Walker (RW),Boston College,28,0,5,5,0.18,25,4
990,Levi Kleiboer (D),University of Maine,29,0,5,5,0.17,10,1
991,Erik Urbank (RW),Dartmouth College,30,0,5,5,0.17,8,-2
992,Joseph Campolieto (D),Union College,31,0,5,5,0.16,39,-14
993,Yevgen Fadyeyev (F),Ohio State University,32,0,5,5,0.16,21,-5
994,Kyle Hallbauer (D),RPI (Rensselaer Polytech. Inst.),33,0,5,5,0.15,6,-1
995,Lucas Finner (LW),Ferris State University,5,4,0,4,0.80,23,-1
996,Jonny Hill (D),Niagara University,18,4,0,4,0.22,6,2
997,Jack Donato (F),Harvard University,31,4,0,4,0.13,14,-4
998,Logan Jenuwine (F),Arizona State University,10,3,1,4,0.40,8,-2
999,Joey Cipollone (C),University of Vermont,13,3,1,4,0.31,4,-7
1000,Danny DiGrande (C),RPI (Rensselaer Polytech. Inst.),18,3,1,4,0.22,10,-1
1001,Jack DeBoer (C),Boston University,20,3,1,4,0.20,8,1
1002,Dylan Mills (C),Niagara University,27,3,1,4,0.15,56,-7
1003,Will Hammer (F),St. Cloud State University,32,3,1,4,0.13,4,3
1004,Christopher Berger (LW),Brown University,9,2,2,4,0.44,6,-3
1005,Colton Trumbla (LW),RIT (Rochester Inst. of Tech.),12,2,2,4,0.33,4,5
1006,Andrew Dumaresque (C),College of the Holy Cross,14,2,2,4,0.29,6,-2
1007,Emil Öhrvall (LW),University of Michigan,15,2,2,4,0.27,2,1
1008,Kevin Obssuth (LW),Canisius College,18,2,2,4,0.22,14,-3
1009,Brett Jewell (RW),Yale University,20,2,2,4,0.20,38,1
1010,Christian Mohs (F),Miami University (Ohio),21,2,2,4,0.19,4,-4
1011,Reid Yochim (D),Princeton University,22,2,2,4,0.18,18,-5
1012,Nathan Plessis (F),Brown University,22,2,2,4,0.18,40,-8
1013,Jake Nielsen (F),St. Lawrence University,23,2,2,4,0.17,4,-3
1014,Gvido Jansons (D),Arizona State University,23,2,2,4,0.17,16,3
1015,Filip Fornåå Svensson (C/RW),University of Alaska-Fairbanks,24,2,2,4,0.17,4,-2
1016,Grant Frederic (D),Miami University (Ohio),27,2,2,4,0.15,6,-4
1017,Austin O'Rourke (F),UMass-Lowell,27,2,2,4,0.15,18,4
1018,Noah Prokop (C),University of Nebraska-Omaha,27,2,2,4,0.15,35,-5
1019,Marcus Mitchell (RW),University of Alaska-Anchorage,30,2,2,4,0.13,39,-4
1020,Hugo Esselin (C),Merrimack College,31,2,2,4,0.13,8,-4
1021,Markuss Komuls (D),University of Alaska-Fairbanks,35,2,2,4,0.11,10,7
1022,Bryan Basilico (LW),Lake Superior State University,39,2,2,4,0.10,18,-3
1023,Patrick Kramer (C),Merrimack College,9,1,3,4,0.44,18,-3
1024,Connor Marshall (F),Brown University,11,1,3,4,0.36,0,3
1025,Will Schlagenhauf (F),Bentley University,16,1,3,4,0.25,0,4
1026,Ben Allen (LW),University of Alabama-Huntsville,16,1,3,4,0.25,4,-2
1027,Wyatt Aamodt (D),Minnesota State University (Mankato),18,1,3,4,0.22,12,12
1028,Jack Doremus (C/W),University of Denver,19,1,3,4,0.21,6,3
1029,Rory Herrman (F),RPI (Rensselaer Polytech. Inst.),21,1,3,4,0.19,6,0
1030,Mason Klee (D),RPI (Rensselaer Polytech. Inst.),21,1,3,4,0.19,6,1
1031,Carter Ekberg (D),Air Force Academy,21,1,3,4,0.19,14,-4
1032,Ryan Sandelin (RW/C),Minnesota State University (Mankato),22,1,3,4,0.18,4,4
1033,Desi Burgart (F),Quinnipiac University,22,1,3,4,0.18,19,-2
1034,Dallas Comeau (W/C),University of Vermont,23,1,3,4,0.17,22,-7
1035,Jamie Armstrong (LW/RW),Boston University,23,1,3,4,0.17,25,0
1036,Ben Lown (C),Miami University (Ohio),26,1,3,4,0.15,2,-10
1037,Patrick O'Leary (D),College of the Holy Cross,26,1,3,4,0.15,6,2
1038,Jayden Lee (D),Quinnipiac University,27,1,3,4,0.15,0,3
1039,Clark Kuster (D),St. Cloud State University,27,1,3,4,0.15,25,4
1040,Sebastian Dirven (D),Cornell University,28,1,3,4,0.14,18,10
1041,Matthew Steeves (F),University of Notre Dame,29,1,3,4,0.14,6,0
1042,Samuli Niinisaari (D),Brown University,29,1,3,4,0.14,10,-10
1043,Derek Hamelin (D),Canisius College,29,1,3,4,0.14,12,-4
1044,Marcus Joseph (D),Sacred Heart University,31,1,3,4,0.13,16,3
1045,Lucas Bahn (D),University of Alabama-Huntsville,31,1,3,4,0.13,18,-15
1046,Grayson Constable (F),College of the Holy Cross,33,1,3,4,0.12,10,-4
1047,Craig Needham (C),Providence College,34,1,3,4,0.12,2,-10
1048,Riley Hughes (RW),Northeastern University,34,1,3,4,0.12,25,-8
1049,Sam McCormick (RW),Ohio State University,36,1,3,4,0.11,6,-11
1050,Rylan Yaremko (D/RW),Northern Michigan University,36,1,3,4,0.11,26,0
1051,Nolan Schaeffer (D),Robert Morris University,36,1,3,4,0.11,37,8
1052,Brendan Harris (C/LW),Bemidji State University,11,0,4,4,0.36,15,1
1053,Zach Yon (LW),University of North Dakota,16,0,4,4,0.25,0,2
1054,Philip Alftberg (D),St. Lawrence University,18,0,4,4,0.22,12,-10
1055,Joey Marooney (RW),University of Minnesota,20,0,4,4,0.20,8,0
1056,Travis Kothenbeutel (F),University of Nebraska-Omaha,21,0,4,4,0.19,4,0
1057,Matt Foley (D),Yale University,21,0,4,4,0.19,4,-4
1058,Jamie Collins (F),Clarkson University,24,0,4,4,0.17,4,2
1059,Brock Paul (D),Dartmouth College,24,0,4,4,0.17,20,0
1060,Jacob Kauppila (LW),Bentley University,25,0,4,4,0.16,31,-1
1061,Andrew Sinard (D),Miami University (Ohio),27,0,4,4,0.15,14,-1
1062,Ryan Wheeler (D/F),University of Connecticut,28,0,4,4,0.14,6,10
1063,Drayson Pears (D),University of Alaska-Anchorage,28,0,4,4,0.14,6,-15
1064,Scott Corbett (C),Miami University (Ohio),29,0,4,4,0.14,16,-16
1065,Dom Garcia (F),Arizona State University,29,0,4,4,0.14,18,2
1066,Kyle Looft (D),Bemidji State University,33,0,4,4,0.12,4,13
1067,Patrick Cozzi (RW),Colorado College,34,0,4,4,0.12,6,-7
1068,Anthony Stark (D),Colgate University,34,0,4,4,0.12,8,-5
1069,Alex Vlasic (D),Boston University,34,0,4,4,0.12,10,-5
1070,Michael Karow (D),Boston College,34,0,4,4,0.12,12,10
1071,Max Coyle (D),University of Alabama-Huntsville,34,0,4,4,0.12,42,-22
1072,Griffin Luce (D),University of Michigan,35,0,4,4,0.11,25,4
1073,Adam Goodsir (F),Michigan State University,36,0,4,4,0.11,16,-2
1074,Sam Morton (C/LW),Union College,13,2,1,3,0.23,2,-7
1075,Chris Van Os-Shaw (LW),Minnesota State University (Mankato),15,2,1,3,0.20,21,7
1076,Ryan Mahshie (F),RPI (Rensselaer Polytech. Inst.),16,2,1,3,0.19,4,-4
1077,Erkka Vänskä (F),College of the Holy Cross,17,2,1,3,0.18,2,1
1078,Jamie Engelbert (C),Providence College,19,2,1,3,0.16,29,-1
1079,Alex Stevens (D),Penn State University,20,2,1,3,0.15,12,-2
1080,Logan Coomes (LW),University of Alaska-Fairbanks,23,2,1,3,0.13,8,-2
1081,Callum Cusinato (C/LW),St. Lawrence University,23,2,1,3,0.13,12,-5
1082,Carter Johnson (C),Miami University (Ohio),23,2,1,3,0.13,19,-5
1083,Corey Renwick (F),University of Alaska-Anchorage,24,2,1,3,0.13,4,-7
1084,Griff Jeszka (F),Merrimack College,25,2,1,3,0.12,6,-9
1085,Ethan Roswell (D),Bentley University,26,2,1,3,0.12,4,3
1086,John Schuldt (D),University of Nebraska-Omaha,26,2,1,3,0.12,33,1
1087,Harrison Markell (D),Dartmouth College,27,2,1,3,0.11,2,-10
1088,Matt Jennings (C),Ohio State University,29,2,1,3,0.10,0,-3
1089,Matt Riggleman (F),Bentley University,29,2,1,3,0.10,14,-10
1090,Cade Townend (D),Mercyhurst University,31,2,1,3,0.10,8,-27
1091,Spenser Young (D),Providence College,32,2,1,3,0.09,26,-6
1092,Charlie Raith (D),University of Notre Dame,36,2,1,3,0.08,19,5
1093,Cam Burke (C),University of Notre Dame,36,2,1,3,0.08,23,-3
1094,Michael Gildon (C/LW),Ohio State University,8,1,2,3,0.38,2,-3
1095,Kevin Hock (F),University of Maine,11,1,2,3,0.27,2,2
1096,Evan Tschumi (C/W),Colgate University,13,1,2,3,0.23,12,3
1097,Blake Wells (F),UMass-Lowell,14,1,2,3,0.21,12,2
1098,Oskar Andrén (RW),Ferris State University,16,1,2,3,0.19,21,-8
1099,Cameron Hebert (RW),Robert Morris University,18,1,2,3,0.17,4,-5
1100,Ryan Nolan (F),Merrimack College,18,1,2,3,0.17,6,-4
1101,Andrew Kruse (D),Air Force Academy,18,1,2,3,0.17,10,6
1102,Zach Tupker (C),Cornell University,20,1,2,3,0.15,2,7
1103,Hayden Rowan (LW),Yale University,20,1,2,3,0.15,8,-6
1104,Jeremy Davidson (RW),UMass,22,1,2,3,0.14,6,-1
1105,Corey Moriarty (D),University of Vermont,22,1,2,3,0.14,10,-4
1106,Frédéric Grégoire (F),Harvard University,22,1,2,3,0.14,16,-6
1107,Simon Boyko (RW),University of Vermont,23,1,2,3,0.13,2,-3
1108,Kevin Lombardi (RW/LW),Sacred Heart University,24,1,2,3,0.13,4,-7
1109,Brenden Datema (D),Michigan Tech,24,1,2,3,0.13,18,1
1110,Alec Capstick (D),Miami University (Ohio),26,1,2,3,0.12,2,-16
1111,Troy Van Tetering (LW),University of Alaska-Fairbanks,27,1,2,3,0.11,4,-3
1112,Chase Gamelin (F),Lake Superior State University,29,1,2,3,0.10,4,-5
1113,Charlie Barrow (D),College of the Holy Cross,30,1,2,3,0.10,10,-10
1114,Gianfranco Cassaro (D),UMass,30,1,2,3,0.10,12,0
1115,Cameron Spicer (D),University of Maine,30,1,2,3,0.10,16,5
1116,Brock Caufield (RW),University of Wisconsin,31,1,2,3,0.10,0,-3
1117,Chad Sasaki (D),Colorado College,31,1,2,3,0.10,6,-11
1118,David Baskerville (C),Canisius College,31,1,2,3,0.10,8,-6
1119,Chandler Lindstrand (D),Yale University,32,1,2,3,0.09,16,-5
1120,Carter Long (D),University of Vermont,33,1,2,3,0.09,27,-10
1121,Jack Quinlivan (F),University of Maine,34,1,2,3,0.09,16,0
1122,Taylor Brierley (D),Union College,35,1,2,3,0.09,8,-11
1123,Chris Lipe (D),Michigan Tech,36,1,2,3,0.08,12,3
1124,Pierce Crawford (F),University of Notre Dame,37,1,2,3,0.08,16,-5
1125,Nick Bowman (F),RPI (Rensselaer Polytech. Inst.),10,0,3,3,0.30,0,-1
1126,Shane Bear (D),RPI (Rensselaer Polytech. Inst.),15,0,3,3,0.20,2,-4
1127,Garrett Pyke (D),University of Alaska-Fairbanks,15,0,3,3,0.20,8,2
1128,Brandon Tabakin (D),Yale University,17,0,3,3,0.18,0,-5
1129,Marshal Plunkett (D),Army (U.S. Military Academy),17,0,3,3,0.18,0,-2
1130,Jason Brancheau (F),Ferris State University,18,0,3,3,0.17,2,-8
1131,Ross Craig (D),Colgate University,21,0,3,3,0.14,14,5
1132,Scott Persson (D),Niagara University,22,0,3,3,0.14,6,-6
1133,Hunter Toale (D),Bentley University,22,0,3,3,0.14,20,2
1134,C.J. Regula (D),Ohio State University,23,0,3,3,0.13,0,-2
1135,Cody Haiskanen (D),Cornell University,23,0,3,3,0.13,4,3
1136,Peyton Reeves (LW),UMass,23,0,3,3,0.13,6,0
1137,Nolan Sawchuk (D),UMass-Lowell,23,0,3,3,0.13,8,-1
1138,Scooter Brickey (D),Western Michigan University,24,0,3,3,0.13,8,-3
1139,Ashton Stockie (C),Mercyhurst University,25,0,3,3,0.12,4,-16
1140,Jacob Modry (D),Merrimack College,26,0,3,3,0.12,6,-15
1141,Ben Mirageas (D),Providence College,26,0,3,3,0.12,14,5
1142,Michael Laidley (LW),St. Lawrence University,28,0,3,3,0.11,16,-7
1143,Jordan Wishman (D),Niagara University,29,0,3,3,0.10,20,1
1144,Jesse Jacques (F),University of Minnesota-Duluth,29,0,3,3,0.10,21,-5
1145,Lucas Herrmann (F),University of New Hampshire,30,0,3,3,0.10,8,-2
1146,Dorian Dawson (D),Brown University,30,0,3,3,0.10,8,-6
1147,Carmine Buono (D),University of Alaska-Anchorage,30,0,3,3,0.10,15,-6
1148,Colin Doyle (C),University of Alaska-Fairbanks,30,0,3,3,0.10,23,-7
1149,Jarod Hilderman (D),University of Minnesota-Duluth,32,0,3,3,0.09,14,4
1150,Adam Karashik (D),University of Connecticut,33,0,3,3,0.09,18,-7
1151,Alex Brink (C),Boston University,34,0,3,3,0.09,29,-10
1152,Christian Krygier (D),Michigan State University,35,0,3,3,0.09,48,0
1153,Ben Brinkman (D),University of Minnesota,36,0,3,3,0.08,8,-3
1154,Layton Ahac (D),Ohio State University,36,0,3,3,0.08,25,10
1155,Marcel Godbout (C/RW),Sacred Heart University,5,2,0,2,0.40,0,2
1156,Liam Motley (F),Cornell University,5,2,0,2,0.40,0,2
1157,Benjamin Tupker (LW),Cornell University,8,2,0,2,0.25,2,2
1158,Ted McGeen (LW),St. Lawrence University,10,2,0,2,0.20,2,-2
1159,Ryan Blankemeier (C),Dartmouth College,13,2,0,2,0.15,0,0
1160,Cullen Munson (C),University of Minnesota,16,2,0,2,0.13,2,-1
1161,Frank Boie (D),College of the Holy Cross,19,2,0,2,0.11,4,7
1162,Reed Robinson (F),Niagara University,24,2,0,2,0.08,2,-2
1163,Patrick Smyth (F),Army (U.S. Military Academy),28,2,0,2,0.07,6,-10
1164,J.D. Pogue (LW),Canisius College,36,2,0,2,0.06,37,-8
1165,Jere Astrén (D),Clarkson University,7,1,1,2,0.29,16,0
1166,Sean Rappleyea (D),University of Alabama-Huntsville,9,1,1,2,0.22,0,-2
1167,Drake Glover (C),University of Alaska-Anchorage,10,1,1,2,0.20,0,-1
1168,Samuel Solenský (C/RW),Bemidji State University,10,1,1,2,0.20,2,1
1169,Brandon Puricelli (RW),University of Minnesota-Duluth,12,1,1,2,0.17,4,0
1170,Riley McCutcheon (F),University of Vermont,12,1,1,2,0.17,6,1
1171,Jakub Lacka (LW),RPI (Rensselaer Polytech. Inst.),12,1,1,2,0.17,12,-1
1172,Joe Winkelmann (C),Bentley University,13,1,1,2,0.15,2,0
1173,Bennett Norlin (F),Air Force Academy,14,1,1,2,0.14,2,-5
1174,Max Sauvé (F),Penn State University,14,1,1,2,0.14,4,-2
1175,Tucker DeYoung (F),Army (U.S. Military Academy),16,1,1,2,0.13,2,-7
1176,Kevin Dineen (F),Army (U.S. Military Academy),16,1,1,2,0.13,6,-1
1177,Adrian Danchenko (F),University of Alabama-Huntsville,16,1,1,2,0.13,8,-4
1178,Will Scherer (D),Canisius College,16,1,1,2,0.13,20,-8
1179,Bobby Young (C),College of the Holy Cross,18,1,1,2,0.11,8,-3
1180,Joe Cipollone (C),University of New Hampshire,19,1,1,2,0.11,6,1
1181,Alec Mahalak (D),Miami University (Ohio),21,1,1,2,0.10,6,-12
1182,Collin Peters (F),Ohio State University,22,1,1,2,0.09,16,-6
1183,Mick Messner (LW),University of Wisconsin,23,1,1,2,0.09,12,-5
1184,Brody Valette (D),RIT (Rochester Inst. of Tech.),23,1,1,2,0.09,31,4
1185,Justin Fregona (RW),University of New Hampshire,24,1,1,2,0.08,6,-1
1186,Joe Sacco (RW),University of New Hampshire,27,1,1,2,0.07,4,-3
1187,Matt Thomson (LW),Northeastern University,29,1,1,2,0.07,4,-4
1188,Pierce Pluemer (LW),Air Force Academy,30,1,1,2,0.07,10,-2
1189,Logan Britt (D),Quinnipiac University,30,1,1,2,0.07,10,-2
1190,T.J. Friedmann (W/C),Quinnipiac University,32,1,1,2,0.06,2,-12
1191,Michael Ryan (D),Union College,32,1,1,2,0.06,12,-12
1192,Austin Kamer (RW),Michigan State University,34,1,1,2,0.06,2,-3
1193,Dominic Lutz (W),Ferris State University,34,1,1,2,0.06,34,-6
1194,Steenn Pasichnuk (RW),Arizona State University,35,1,1,2,0.06,29,-10
1195,Quinn Wichers (D),Mercyhurst University,36,1,1,2,0.06,20,-21
1196,Arvid Henrikson (D),Lake Superior State University,37,1,1,2,0.05,48,2
1197,Merritt Oszytko (F),RIT (Rochester Inst. of Tech.),4,0,2,2,0.50,0,2
1198,Erik Middendorf (LW),Colorado College,6,0,2,2,0.33,4,1
1199,Quinton Ong (RW),Yale University,8,0,2,2,0.25,2,-3
1200,Logan Milliken (D),College of the Holy Cross,8,0,2,2,0.25,4,1
1201,Jordan Muzzillo (D),University of Alaska-Fairbanks,8,0,2,2,0.25,4,3
1202,Christian Simeone (F),Merrimack College,9,0,2,2,0.22,0,0
1203,Bradley Stonnell (D),Robert Morris University,10,0,2,2,0.20,8,1
1204,Jake Witkowski (F),Boston University,11,0,2,2,0.18,2,1
1205,Kyler Kupka (F),St. Cloud State University,12,0,2,2,0.17,0,0
1206,Derek Contessa (RW),Sacred Heart University,12,0,2,2,0.17,2,2
1207,Lucas Breault (C),Union College,12,0,2,2,0.17,6,-7
1208,Jason Pineo (C),Niagara University,12,0,2,2,0.17,8,1
1209,Dan Petrick (D),Sacred Heart University,14,0,2,2,0.14,4,1
1210,Joe Cassetti (C/LW),Merrimack College,14,0,2,2,0.14,14,-6
1211,Thomas Rocco (F),St. Cloud State University,15,0,2,2,0.13,2,-1
1212,McKay Flanagan (D),Colorado College,16,0,2,2,0.13,2,-2
1213,Dalton Weigel (D),Air Force Academy,16,0,2,2,0.13,6,-6
1214,Adam Robbins (F),Princeton University,18,0,2,2,0.11,2,-9
1215,Tyler Love (D),Robert Morris University,18,0,2,2,0.11,17,-5
1216,Jordan Timmons (F),University of Connecticut,19,0,2,2,0.11,4,-4
1217,Kendrick Frost (LW),Army (U.S. Military Academy),19,0,2,2,0.11,4,0
1218,Erich Fear (D),University of Denver,20,0,2,2,0.10,4,1
1219,Jake Crespi (D),Michigan Tech,20,0,2,2,0.10,14,-2
1220,Brendan Schneider (C),Mercyhurst University,21,0,2,2,0.10,8,-9
1221,Drew Lennon (D),University of Alabama-Huntsville,22,0,2,2,0.09,10,-6
1222,Alec Semandel (D),Lake Superior State University,22,0,2,2,0.09,12,1
1223,Michael Bevilacqua (D),Mercyhurst University,23,0,2,2,0.09,4,-13
1224,Max Finner (D),Ferris State University,23,0,2,2,0.09,25,-3
1225,Jeffrey Stewart (LW),Colgate University,24,0,2,2,0.08,0,-2
1226,Troy Robillard (D),University of Alaska-Anchorage,24,0,2,2,0.08,18,-8
1227,Tanner Vescio (D),Northern Michigan University,25,0,2,2,0.08,6,-1
1228,Nick Seitz (F),Princeton University,25,0,2,2,0.08,6,-7
1229,C.J. McGee (D),Quinnipiac University,25,0,2,2,0.08,8,4
1230,Matthew O'Donnell (D),University of Vermont,25,0,2,2,0.08,8,-13
1231,Casey Jerry (F),Canisius College,25,0,2,2,0.08,33,-8
1232,Brian Hawkinson (RW),Miami University (Ohio),26,0,2,2,0.08,10,-5
1233,Tyler Jubenvill (D),Bemidji State University,27,0,2,2,0.07,6,-1
1234,Peyton Francis (C),University of Alabama-Huntsville,29,0,2,2,0.07,2,-14
1235,Dominick Mersch (C),University of Wisconsin,30,0,2,2,0.07,10,-7
1236,Owen Grant (D),University of Vermont,30,0,2,2,0.07,30,-13
1237,Liam Watson-Brawn (D),Colgate University,32,0,2,2,0.06,37,-5
1238,Bailey Newton (D),University of Alabama-Huntsville,33,0,2,2,0.06,32,-14
1239,Matt Anderson (D),University of Minnesota-Duluth,34,0,2,2,0.06,14,-7
1240,Michael Underwood (D),Clarkson University,34,0,2,2,0.06,28,10
1241,Nolan Nicholas (D),University of Alaska-Anchorage,36,0,2,2,0.06,12,-9
1242,Chaz Switzer (D),Miami University (Ohio),4,1,0,1,0.25,4,-1
1243,Nick Leitner (D),Bemidji State University,5,1,0,1,0.20,2,3
1244,Jan Stefka (F),American International College,7,1,0,1,0.14,2,-2
1245,Hunter Johannes (LW),American International College,7,1,0,1,0.14,2,2
1246,Max Ellis (RW),University of Notre Dame,8,1,0,1,0.13,4,-1
1247,Josh Rieger (D),University of North Dakota,9,1,0,1,0.11,6,0
1248,Solag Bakich (F),University of Notre Dame,10,1,0,1,0.10,2,2
1249,Nicolas Mucci (F),Niagara University,11,1,0,1,0.09,8,1
1250,Niko Esposito-Selivanov (C),Lake Superior State University,13,1,0,1,0.08,6,-1
1251,Sami Pharaon (D),Princeton University,14,1,0,1,0.07,2,-5
1252,Michael Young (D),Yale University,15,1,0,1,0.07,2,1
1253,Casey Johnson (D),University of North Dakota,16,1,0,1,0.06,2,0
1254,Darby Gula (D),Bemidji State University,17,1,0,1,0.06,2,4
1255,Brenden Rons (D),Ferris State University,20,1,0,1,0.05,4,-13
1256,Dante Spagnuolo (C),Mercyhurst University,20,1,0,1,0.05,6,-15
1257,Kamil Sadlocha (C),Ohio State University,21,1,0,1,0.05,4,-3
1258,Matthew Kellenberger (D),Princeton University,22,1,0,1,0.05,14,-7
1259,John Laurito (F),Army (U.S. Military Academy),23,1,0,1,0.04,12,-2
1260,Brady Smith (D),Colorado College,24,1,0,1,0.04,4,-10
1261,Clayton Han (D),Dartmouth College,24,1,0,1,0.04,4,-5
1262,Teddy Wooding (F),Yale University,25,1,0,1,0.04,4,-10
1263,Cory Thomas (D),University of Vermont,27,1,0,1,0.04,8,-11
1264,Fletcher Fineman (D),Union College,28,1,0,1,0.04,6,0
1265,Cade Kowalski (C/RW),Ferris State University,30,1,0,1,0.03,8,-18
1266,Ryan Sidorski (D),Union College,36,1,0,1,0.03,22,-7
1267,Colby Bukes (D),Minnesota State University (Mankato),2,0,1,1,0.50,0,2
1268,Shane Switzer (D),University of Michigan,2,0,1,1,0.50,0,1
1269,Hunter Lellig (D),University of Minnesota-Duluth,4,0,1,1,0.25,17,1
1270,Mitch Andres (D),Boston College,6,0,1,1,0.17,2,1
1271,Kris Spriggs (LW),Niagara University,6,0,1,1,0.17,2,1
1272,Jesper Peltonen (D),University of Wisconsin,7,0,1,1,0.14,0,-1
1273,Owen Guy (C),Lake Superior State University,7,0,1,1,0.14,0,-3
1274,Ian Johnston (LW),Lake Superior State University,9,0,1,1,0.11,0,-3
1275,Lukas Samuelsson (F),Western Michigan University,9,0,1,1,0.11,2,-2
1276,Andrew Quetell (D),Army (U.S. Military Academy),9,0,1,1,0.11,2,-2
1277,Joe Hankinson (F),University of New Hampshire,10,0,1,1,0.10,2,-1
1278,Andrew Petrillo (D),University of Vermont,10,0,1,1,0.10,4,-3
1279,T.J. Samec (D),RPI (Rensselaer Polytech. Inst.),10,0,1,1,0.10,6,-4
1280,Tommy Lee (F),RPI (Rensselaer Polytech. Inst.),10,0,1,1,0.10,8,-3
1281,Casey Staum (D),Colorado College,11,0,1,1,0.09,4,-6
1282,Cooper Watson (D),Michigan Tech,11,0,1,1,0.09,8,1
1283,Justin Szeto (F),Harvard University,12,0,1,1,0.08,2,1
1284,Alex Cohen (C),Union College,12,0,1,1,0.08,2,-4
1285,Christian LeSueur (RW),Dartmouth College,12,0,1,1,0.08,6,-3
1286,John Carter MacLean (C),Clarkson University,12,0,1,1,0.08,6,0
1287,Wojciech Stachowiak (LW/RW),Michigan State University,13,0,1,1,0.08,0,2
1288,Tyler Anderson (D),St. Cloud State University,13,0,1,1,0.08,2,1
1289,James Marooney (D),Ohio State University,13,0,1,1,0.08,2,-2
1290,Robert Griffin (C),University of New Hampshire,13,0,1,1,0.08,15,-2
1291,Alex Mella (LW),Northeastern University,14,0,1,1,0.07,0,-1
1292,Wyllum Deveaux (F),Harvard University,14,0,1,1,0.07,2,-2
1293,Collin Murphy (D),Northeastern University,14,0,1,1,0.07,4,1
1294,Ben Almquist (F),University of Minnesota-Duluth,14,0,1,1,0.07,4,1
1295,Jackson Ross (D),Colorado College,16,0,1,1,0.06,2,0
1296,Nick Parody (D),Canisius College,17,0,1,1,0.06,4,1
1297,Luke Perunovich (D),Providence College,17,0,1,1,0.06,4,2
1298,Davis Bunz (D),Providence College,17,0,1,1,0.06,6,4
1299,Jarrett Lee (F),Northern Michigan University,17,0,1,1,0.06,15,2
1300,Quinn Warmuth (D),Robert Morris University,18,0,1,1,0.06,2,-3
1301,John Stampohar (D),Canisius College,18,0,1,1,0.06,12,-6
1302,George Mika (F),UMass,19,0,1,1,0.05,4,0
1303,Markus Boguslavsky (RW),Boston University,19,0,1,1,0.05,4,-2
1304,Matt Cairns (D),Cornell University,19,0,1,1,0.05,4,4
1305,Jace Foskey (D),Harvard University,19,0,1,1,0.05,12,-4
1306,Bryce Dolan (D),College of the Holy Cross,20,0,1,1,0.05,2,-11
1307,David Trinkberger (D),University of Alaska-Anchorage,21,0,1,1,0.05,21,-10
1308,Alec Mehr (C),Brown University,22,0,1,1,0.05,4,-4
1309,Mitchell Mattson (C),Michigan State University,22,0,1,1,0.05,4,1
1310,Carson Dimoff (LW),St. Lawrence University,22,0,1,1,0.05,6,-6
1311,Connor Stuart (D/F),Arizona State University,24,0,1,1,0.04,4,-4
1312,Noah Wilson (D),Army (U.S. Military Academy),25,0,1,1,0.04,8,-5
1313,Garrett Daly (D),Bowling Green State University,25,0,1,1,0.04,14,1
1314,Jordan Fogarty (F),Princeton University,26,0,1,1,0.04,6,-7
1315,James Gobetz (D),Penn State University,26,0,1,1,0.04,8,1
1316,Mason Palmer (D),Northern Michigan University,28,0,1,1,0.04,14,-2
1317,Anea Ferrario (D),Brown University,30,0,1,1,0.03,10,-18
1318,Aaron McPheters (D),University of Alaska-Anchorage,30,0,1,1,0.03,29,-4
1319,Joey Fallon (F),Princeton University,31,0,1,1,0.03,8,-11
1320,Tyler Heidt (D),Merrimack College,31,0,1,1,0.03,8,-3
1321,MacGregor Sinclair (C),Canisius College,32,0,1,1,0.03,8,-11
1322,Devon Daniels (D),Mercyhurst University,32,0,1,1,0.03,22,-23
1323,Joe Tyran (D),Air Force Academy,33,0,1,1,0.03,8,-8
1324,Jeff Clarke (D),St. Lawrence University,35,0,1,1,0.03,41,-8
1325,Jackson Hartje (D),Harvard University,0,0,0,0,0.00,0,0
1326,Trevor Zins (D),St. Cloud State University,0,0,0,0,0.00,0,0
1327,Jared Resseguie (F),University of Denver,0,0,0,0,0.00,0,0
1328,Tony Malinowski (D),Minnesota State University (Mankato),0,0,0,0,0.00,0,0
1329,Louis Helsen (D),RPI (Rensselaer Polytech. Inst.),0,0,0,0,0.00,0,0
1330,Remy Parker (F),University of Maine,0,0,0,0,0.00,0,0
1331,Coby Mack (D),Army (U.S. Military Academy),0,0,0,0,0.00,0,0
1332,Austin Goldstein (F),Northeastern University,0,0,0,0,0.00,0,0
1333,Brian Kelly (D),University of Vermont,0,0,0,0,0.00,0,0
1334,Matt Denman (D),University of Minnesota,0,0,0,0,0.00,0,0
1335,Thomas Maia (LW),RIT (Rochester Inst. of Tech.),0,0,0,0,0.00,0,0
1336,Nolan McElhaney (D),University of New Hampshire,0,0,0,0,0.00,0,0
1337,Luke Harrington (F),Brown University,0,0,0,0,0.00,0,0
1338,Shane McMahan (LW),Minnesota State University (Mankato),0,0,0,0,0.00,0,0
1339,Filip Forsmark (LW/RW),Merrimack College,0,0,0,0,0.00,0,0
1340,Max Balinson (D),Arizona State University,0,0,0,0,0.00,0,0
1341,Nick Quillan (D),Colgate University,0,0,0,0,0.00,0,0
1342,Jordan Klehr (D),University of Nebraska-Omaha,0,0,0,0,0.00,0,0
1343,Stephen Kleysen (D),Niagara University,0,0,0,0,0.00,0,0
1344,Damian Chrcek (D),Michigan State University,0,0,0,0,0.00,0,0
1345,Neil Doef (LW),Princeton University,0,0,0,0,0.00,0,0
1346,Jeremy Smith (D),Quinnipiac University,0,0,0,0,0.00,0,0
1347,Chase Dubois (F),University of Alaska-Fairbanks,0,0,0,0,0.00,0,0
1348,Jack Adams (RW/C),Union College,0,0,0,0,0.00,0,0
1349,Josh Allan (D),Sacred Heart University,0,0,0,0,0.00,0,0
1350,Colin Tonge (LW),Princeton University,0,0,0,0,0.00,0,0
1351,Blake Bennett (LW/RW),American International College,0,0,0,0,0.00,0,0
1352,Shane Sellar (F),Dartmouth College,0,0,0,0,0.00,0,0
1353,Aidan Girduckis (D),Robert Morris University,0,0,0,0,0.00,0,0
1354,Keegan Mantaro (D),Air Force Academy,0,0,0,0,0.00,0,0
1355,Carter Dwyer (D),Bentley University,0,0,0,0,0.00,0,0
1356,Cameron Babiak (D),Bowling Green State University,0,0,0,0,0.00,0,0
1357,Michael Mannara (D),Lake Superior State University,0,0,0,0,0.00,0,0
1358,Marco Bozzo (C),UMass,0,0,0,0,0.00,0,0
1359,Mitchell Perrault (F),Harvard University,0,0,0,0,0.00,0,0
1360,Andong Song (D),Cornell University,0,0,0,0,0.00,0,0
1361,Christian DiCesare (D),University of Notre Dame,0,0,0,0,0.00,0,0
1362,Jackson MacNab (RW),University of Notre Dame,0,0,0,0,0.00,0,0
1363,Zach Bramwell (F),Cornell University,0,0,0,0,0.00,0,0
1364,Jensen Zerban (F),Air Force Academy,0,0,0,0,0.00,0,0
1365,Ty Amonte (RW),Boston University,0,0,0,0,0.00,0,0
1366,Eric Otto (F),American International College,0,0,0,0,0.00,0,0
1367,Josh Arnold (F),Northern Michigan University,0,0,0,0,0.00,0,0
1368,Peter Muzyka (D),Cornell University,0,0,0,0,0.00,0,0
1369,Carson Albrecht (RW),University of North Dakota,0,0,0,0,0.00,0,0
1370,Justin Wilson (F),American International College,0,0,0,0,0.00,0,0
1371,Jay Keranen (D),University of Michigan,0,0,0,0,0.00,0,0
1372,Noah Weber (F),University of Minnesota,0,0,0,0,0.00,0,0
1373,Ben Pirko (D),Union College,0,0,0,0,0.00,0,0
1374,Roman Kinal (D),University of Connecticut,0,0,0,0,0.00,0,0
1375,Jay Powell (D),University of Alabama-Huntsville,0,0,0,0,0.00,0,0
1376,Kyle Koopman (D),Providence College,0,0,0,0,0.00,0,0
1377,Colby Enns (D),University of Nebraska-Omaha,1,0,0,0,0.00,0,-1
1378,Jett Jungels (F),Northern Michigan University,1,0,0,0,0.00,0,0
1379,Ben Solin (F),Harvard University,1,0,0,0,0.00,0,1
1380,Calvon Boots (D),American International College,1,0,0,0,0.00,0,-1
1381,A.J. Villella (D),Northeastern University,1,0,0,0,0.00,0,0
1382,Cory Caruso (D/F),Mercyhurst University,1,0,0,0,0.00,0,0
1383,John Copeland (F/D),Boston University,1,0,0,0,0.00,0,0
1384,Eddie Pavlini (F),St. Lawrence University,1,0,0,0,0.00,0,0
1385,Tyler Hayes (D),Niagara University,1,0,0,0,0.00,0,0
1386,Derek Osik (C),UMass-Lowell,1,0,0,0,0.00,0,-1
1387,Anthony Scarsella (D),Michigan State University,1,0,0,0,0.00,0,0
1388,Bryan Gerstenfeld (D),Army (U.S. Military Academy),1,0,0,0,0.00,0,-1
1389,Brett Callahan (D),American International College,1,0,0,0,0.00,0,0
1390,Ben DiMaio (D),Dartmouth College,1,0,0,0,0.00,0,0
1391,Nate Hooper (C),American International College,1,0,0,0,0.00,0,0
1392,Matus Spodniak (C/LW),American International College,1,0,0,0,0.00,0,0
1393,Kristaps Jakobsons (D),University of Alaska-Fairbanks,1,0,0,0,0.00,0,0
1394,Jesse Pereira (RW),Canisius College,1,0,0,0,0.00,0,1
1395,Sean Keohan (D),Dartmouth College,1,0,0,0,0.00,2,0
1396,Sam Rossini (D),University of Minnesota,2,0,0,0,0.00,0,2
1397,Cade Gleekel (W),St. Lawrence University,2,0,0,0,0.00,0,0
1398,John Wojciechowski (C),University of Connecticut,2,0,0,0,0.00,0,-1
1399,Sam Kauppila (F),Bentley University,2,0,0,0,0.00,0,0
1400,Shay Donovan (D),University of Wisconsin,2,0,0,0,0.00,0,0
1401,Jack Olmstead (C/LW/RW),University of Michigan,2,0,0,0,0.00,0,-2
1402,David Raisanen (F),Michigan Tech,2,0,0,0,0.00,2,0
1403,Carson Gicewicz (C),St. Lawrence University,2,0,0,0,0.00,2,1
1404,Adrian Holesinsky (RW/C),University of Maine,2,0,0,0,0.00,2,-1
1405,Kenny Johnson (D),Penn State University,2,0,0,0,0.00,2,-1
1406,Roberts Blugers (LW/RW),Lake Superior State University,3,0,0,0,0.00,0,-2
1407,Drew Hickey (D),University of New Hampshire,3,0,0,0,0.00,0,0
1408,Jason Dhooghe (F),University of Wisconsin,3,0,0,0,0.00,0,-1
1409,Christopher Theodore (LW),American International College,3,0,0,0,0.00,0,0
1410,Jay Feiwell (LW),University of Denver,3,0,0,0,0.00,0,0
1411,Matthew Hayami (C),Princeton University,3,0,0,0,0.00,0,0
1412,Andrew Lane (D),University of Alaska-Anchorage,3,0,0,0,0.00,0,-1
1413,Tim Clifton (C),Sacred Heart University,3,0,0,0,0.00,2,0
1414,Adam Pilewicz (D),Penn State University,3,0,0,0,0.00,2,0
1415,Jonny Russell (RW),Brown University,3,0,0,0,0.00,2,-1
1416,Colin Bernard (D),Sacred Heart University,3,0,0,0,0.00,2,0
1417,Casey Carreau (C),Boston College,3,0,0,0,0.00,2,0
1418,Tyrell Buckley (D),Michigan Tech,3,0,0,0,0.00,7,-2
1419,Luke Albert (D),Brown University,4,0,0,0,0.00,0,0
1420,Jax Murray (F),Arizona State University,4,0,0,0,0.00,0,0
1421,Nicholas Wildgoose (RW),St. Lawrence University,4,0,0,0,0.00,0,-1
1422,Lane Krenzen (D),University of Denver,4,0,0,0,0.00,0,0
1423,Alex Pernitsky (D),Colorado College,4,0,0,0,0.00,0,0
1424,Adam Winborg (C),University of Michigan,4,0,0,0,0.00,2,-1
1425,Dawson Bruneski (D),University of Maine,4,0,0,0,0.00,4,-1
1426,Garrett Devine (F),Providence College,4,0,0,0,0.00,8,0
1427,Matty Holmes (F),Brown University,5,0,0,0,0.00,0,-1
1428,Blake Gober (F),Penn State University,5,0,0,0,0.00,0,0
1429,Kolby Vegara (D),UMass,5,0,0,0,0.00,0,-1
1430,Jake Smith (F),Michigan State University,5,0,0,0,0.00,0,0
1431,Perry Winfree (D),University of Maine,5,0,0,0,0.00,0,1
1432,Cameron Orchard (C),Western Michigan University,5,0,0,0,0.00,0,-2
1433,Todd Kiilunen (D),Michigan Tech,5,0,0,0,0.00,2,-1
1434,Dan Winslow (F),Quinnipiac University,5,0,0,0,0.00,4,0
1435,Nic Hamre (LW),University of Vermont,6,0,0,0,0.00,0,-1
1436,Jack Hoey (C),Colgate University,6,0,0,0,0.00,0,0
1437,Brady Gaudette (F),University of Maine,6,0,0,0,0.00,0,-1
1438,Bobby Kaiser (RW),UMass,6,0,0,0,0.00,2,0
1439,Robbie DeMontis (LW),Yale University,6,0,0,0,0.00,2,-4
1440,Zach Salloum (D),RIT (Rochester Inst. of Tech.),6,0,0,0,0.00,6,3
1441,Michael Merulla (C/RW),Boston College,7,0,0,0,0.00,0,0
1442,Brady Meyer (C),University of Minnesota-Duluth,7,0,0,0,0.00,2,0
1443,Christian Hayes (F),College of the Holy Cross,7,0,0,0,0.00,2,-1
1444,Billy Carrabino (D),Northeastern University,7,0,0,0,0.00,4,1
1445,Jordan Robert (F),Clarkson University,7,0,0,0,0.00,8,-2
1446,Ethan Manderville (C),Colgate University,8,0,0,0,0.00,0,-1
1447,Jack Cameron (D),Dartmouth College,8,0,0,0,0.00,0,-5
1448,Jake Gingell (D),University of Michigan,8,0,0,0,0.00,2,-2
1449,Ryan Carmichael (D/F),University of Notre Dame,8,0,0,0,0.00,2,-2
1450,Erich Jaeger (F),Air Force Academy,8,0,0,0,0.00,4,-1
1451,Marcus Russell (F),Michigan Tech,8,0,0,0,0.00,4,0
1452,Jake Harris (LW),Brown University,9,0,0,0,0.00,0,-5
1453,Chase Danol (F),Bowling Green State University,9,0,0,0,0.00,2,-2
1454,Jamie Rome (F),Western Michigan University,9,0,0,0,0.00,4,1
1455,Caleb Rule (F),Providence College,9,0,0,0,0.00,4,2
1456,Ethan Stewart (F),Ferris State University,9,0,0,0,0.00,6,-4
1457,Justin Smith (D),Ferris State University,9,0,0,0,0.00,8,-3
1458,Brennan Blaszczak (F),University of Alaska-Fairbanks,9,0,0,0,0.00,17,-2
1459,Drew Blackmun (F),Union College,10,0,0,0,0.00,0,-2
1460,Cade Borchardt (F),Minnesota State University (Mankato),10,0,0,0,0.00,0,-1
1461,Hugo Blixt (D),Boston University,10,0,0,0,0.00,0,-1
1462,Ben Foley (D),Harvard University,10,0,0,0,0.00,2,0
1463,Edward Lindelöw (C),University of Maine,10,0,0,0,0.00,2,-2
1464,Brad Belisle (C),Bemidji State University,10,0,0,0,0.00,2,-1
1465,Mitch Meek (D),Michigan Tech,10,0,0,0,0.00,2,-1
1466,Dalton Messina (F),Ohio State University,10,0,0,0,0.00,4,1
1467,Oskar Strömberg (D),American International College,10,0,0,0,0.00,6,-4
1468,Kyle Johnson (F),Yale University,11,0,0,0,0.00,0,-1
1469,Aiden Beck (F),Robert Morris University,11,0,0,0,0.00,0,-3
1470,Brian Matthews (D),Yale University,11,0,0,0,0.00,0,-2
1471,Peter Zhong (LW),Arizona State University,11,0,0,0,0.00,0,0
1472,Dante Fantauzzi (D),University of Alaska-Anchorage,11,0,0,0,0.00,0,-8
1473,Nick Azar (D),Harvard University,11,0,0,0,0.00,2,-2
1474,Marcus Chorney (D),Quinnipiac University,12,0,0,0,0.00,4,2
1475,Zach Noble (F),Michigan Tech,12,0,0,0,0.00,6,-2
1476,Teddy Rotenberger (D),University of Alabama-Huntsville,12,0,0,0,0.00,7,-3
1477,Matthew Fawcett (LW),Quinnipiac University,13,0,0,0,0.00,2,-3
1478,Cale List (D),UMass-Lowell,13,0,0,0,0.00,2,-1
1479,Jack Weiss (D),University of Alaska-Fairbanks,13,0,0,0,0.00,6,-3
1480,Jordan Schulting (D),UMass-Lowell,14,0,0,0,0.00,0,3
1481,Brian Williams (C),Colorado College,14,0,0,0,0.00,0,-2
1482,Mark Mahoney (D),St. Lawrence University,14,0,0,0,0.00,0,1
1483,Alexandre Roy (D),University of Nebraska-Omaha,14,0,0,0,0.00,2,0
1484,Matthew Dawson (D),University of New Hampshire,14,0,0,0,0.00,4,-3
1485,Eric Linell (C/RW),University of Connecticut,14,0,0,0,0.00,4,-7
1486,Jerry Harding (F),Providence College,14,0,0,0,0.00,6,-1
1487,Joe Sofo (F),University of Alaska-Anchorage,14,0,0,0,0.00,23,-2
1488,Spencer Berry (D),RIT (Rochester Inst. of Tech.),15,0,0,0,0.00,4,0
1489,Sean Driscoll (D),Boston University,15,0,0,0,0.00,6,-1
1490,Trevor St. Jean (F),Bowling Green State University,16,0,0,0,0.00,2,0
1491,Eric Faith (LW),UMass,17,0,0,0,0.00,6,-1
1492,Lincoln Erne (D),Canisius College,18,0,0,0,0.00,20,-4
1493,Geoff Lawson (D),Robert Morris University,19,0,0,0,0.00,4,-5
1494,Keenan Lund (F),Air Force Academy,23,0,0,0,0.00,4,-5
1495,Jack Gessert (LW),Brown University,25,0,0,0,0.00,10,-5
1496,Jake Rosenbaum (D),University of Minnesota-Duluth,27,0,0,0,0.00,0,-5
1497,John McDermott (LW),Providence College,27,0,0,0,0.00,12,-4
1498,Cameron White (D),St. Lawrence University,28,0,0,0,0.00,6,-5
1499,Ben Taylor (RW),Brown University,28,0,0,0,0.00,6,-8
1500,T.J. Polglaze (F),Michigan Tech,29,0,0,0,0.00,0,-3
