ID,Player,Team,GP,G,A,TP,PPG,PIM,PM
1,Alex Limoges (LW/C),Penn State University,39,23,27,50,1.28,10,23
2,Taro Hirose (LW),Michigan State University,36,15,35,50,1.39,12,14
3,Cale Makar (D),UMass,41,16,33,49,1.20,31,32
4,Adam Fox (D),Harvard University,33,9,39,48,1.45,14,23
5,Patrick Newell (W/C),St. Cloud State University,39,21,26,47,1.21,8,35
6,Joseph Duszak (D),Mercyhurst University,37,16,31,47,1.27,42,8
7,Jacob Pritchard (LW),UMass,41,16,31,47,1.15,8,8
8,Blake Christensen (LW),American International College,41,16,31,47,1.15,22,2
9,Josh Wilkins (C/W),Providence College,40,20,26,46,1.15,10,9
10,Rem Pitlick (C/RW),University of Minnesota,38,21,24,45,1.18,30,4
11,Nico Sturm (C/LW),Clarkson University,39,14,31,45,1.15,29,23
12,Ryan Kuffner (LW),Princeton University,31,22,22,44,1.42,8,2
13,Max Johnson (C),Bowling Green State University,41,19,24,43,1.05,31,11
14,Evan Barratt (C/LW),Penn State University,32,16,27,43,1.34,55,19
15,Ludwig Stenlund (C),Niagara University,41,23,19,42,1.02,14,-11
16,Marc Michaelis (LW/C),Minnesota State University (Mankato),42,19,23,42,1.00,25,22
17,Liam Folkes (C),Penn State University,39,18,24,42,1.08,8,20
18,Mitchell Chaffee (RW),UMass,40,18,24,42,1.05,33,21
19,Odeen Tufto (C),Quinnipiac University,38,15,27,42,1.11,16,12
20,Blake Lizotte (C/LW),St. Cloud State University,37,14,28,42,1.14,28,28
21,Diego Cuglietta (C),Lake Superior State University,38,25,16,41,1.08,18,24
22,Tyler Sheehy (C),University of Minnesota,38,12,29,41,1.08,26,3
23,Brandon Kruse (LW),Bowling Green State University,41,10,31,41,1.00,30,15
24,Troy Loggins (LW),Northern Michigan University,39,23,17,40,1.03,46,9
25,Dylan McLaughlin (C),Canisius College,37,19,21,40,1.08,4,-6
26,Robby Jackson (LW/C),St. Cloud State University,37,19,21,40,1.08,18,22
27,Haralds Egle (C/RW),Clarkson University,39,19,21,40,1.03,16,12
28,Brandon Biro (C/LW),Penn State University,37,16,24,40,1.08,4,15
29,John Leonard (LW/RW),UMass,40,16,24,40,1.00,24,14
30,Noah Delmas (D),Niagara University,41,15,25,40,0.98,14,-1
31,Parker Tuomie (RW),Minnesota State University (Mankato),36,14,26,40,1.11,52,14
32,Alex Tonge (C/LW),Robert Morris University,39,19,20,39,1.00,14,-4
33,Chase Priskie (D),Quinnipiac University,36,17,22,39,1.08,23,18
34,Jack Dugan (LW/RW),Providence College,41,10,29,39,0.95,48,5
35,Colt Conrad (C),Western Michigan University,37,11,27,38,1.03,14,5
36,Nate Sucese (LW),Penn State University,39,19,18,37,0.95,24,18
37,Patrick Khodorenko (C),Michigan State University,36,18,19,37,1.03,30,6
38,Derek Barach (C),Mercyhurst University,38,15,22,37,0.97,28,1
39,Max Véronneau (RW),Princeton University,31,13,24,37,1.19,2,0
40,David Cotton (C),Boston College,39,23,13,36,0.92,20,-8
41,Mason Jobst (C/LW),Ohio State University,36,17,19,36,1.00,20,8
42,Joel Farabee (LW/RW),Boston University,37,17,19,36,0.97,57,4
43,Liam Finlay (RW/C),University of Denver,41,16,20,36,0.88,20,16
44,Joe Snively (LW),Yale University,33,15,21,36,1.09,17,5
45,Luke Santerno (F),Bentley University,37,11,25,36,0.97,26,9
46,Abbott Girduckis (RW/C),RIT (Rochester Inst. of Tech.),38,11,25,36,0.95,4,-2
47,Mitchell Fossier (LW),University of Maine,36,8,28,36,1.00,14,12
48,Jérémy Davies (D),Northeastern University,37,8,28,36,0.97,41,8
49,Drew Callin (C/RW),Bentley University,37,10,25,35,0.95,22,12
50,Jimmy Schuldt (D),St. Cloud State University,39,10,25,35,0.90,18,24
51,Dalton MacAfee (D),Army (U.S. Military Academy),39,10,25,35,0.90,36,-3
52,Adam Rockwood (C),Northern Michigan University,38,7,28,35,0.92,6,5
53,Philip Beaulieu (D),Northern Michigan University,38,6,29,35,0.92,26,16
54,Johnny Walker (RW),Arizona State University,32,23,11,34,1.06,34,8
55,Mason Morelli (LW/C),University of Nebraska-Omaha,36,19,15,34,0.94,12,-16
56,Connor Ford (C),Bowling Green State University,40,17,17,34,0.85,16,9
57,Josh Passolt (LW),Western Michigan University,36,16,18,34,0.94,14,14
58,Mitch Lewandowski (LW),Michigan State University,36,16,18,34,0.94,26,5
59,Morgan Barron (C/W),Cornell University,36,15,19,34,0.94,26,9
60,Trey Bradley (C),Colorado College,41,15,19,34,0.83,10,-4
61,Brandon Duhaime (RW/LW),Providence College,42,11,23,34,0.81,53,15
62,Fredrik Olofsson (LW/C),University of Nebraska-Omaha,36,10,24,34,0.94,12,-14
63,Bobby Nardella (D),University of Notre Dame,38,8,26,34,0.89,20,5
64,Jack Ahcan (D),St. Cloud State University,39,6,28,34,0.87,38,30
65,Max Humitz (C/LW),Lake Superior State University,36,16,17,33,0.92,25,14
66,Parker MacKay (RW),University of Minnesota-Duluth,40,16,17,33,0.83,14,19
67,Anthony Nellis (LW/C),Lake Superior State University,38,15,18,33,0.87,28,11
68,Brandon Hawkins (RW/LW),Northeastern University,39,12,21,33,0.85,23,6
69,Dante Fabbro (D),Boston University,38,7,26,33,0.87,39,-3
70,Quinn Hughes (D),University of Michigan,32,5,28,33,1.03,16,-2
71,Justin Richards (C),University of Minnesota-Duluth,42,12,20,32,0.76,18,20
72,Cole Maier (C/LW),Union College,39,9,23,32,0.82,24,10
73,William Lockwood (RW),University of Michigan,36,16,15,31,0.86,24,8
74,Jonathan Desbiens (LW),Bentley University,35,15,16,31,0.89,46,12
75,Brent Gates (C),University of Minnesota,38,13,18,31,0.82,4,1
76,Reilly Walsh (D),Harvard University,33,12,19,31,0.94,12,-2
77,Luke Lynch (C),Robert Morris University,40,10,21,31,0.78,52,-1
78,Justin Baudry (D),Bemidji State University,38,9,22,31,0.82,34,7
79,Ryan Poehling (C/LW),St. Cloud State University,36,8,23,31,0.86,34,12
80,Adam Brubacher (D),RIT (Rochester Inst. of Tech.),38,7,24,31,0.82,22,5
81,Kasper Björkqvist (RW/LW),Providence College,42,17,13,30,0.71,20,13
82,Hugh McGing (LW/C),Western Michigan University,37,16,14,30,0.81,55,2
83,Jake Hamacher (LW),RIT (Rochester Inst. of Tech.),38,14,16,30,0.79,10,1
84,Brinson Pasichnuk (D),Arizona State University,35,13,17,30,0.86,28,25
85,Westin Michaud (LW/C),Colorado College,41,13,17,30,0.73,30,13
86,Cal Burke (C/RW),University of Notre Dame,36,12,18,30,0.83,8,9
87,Josh Lammon (C),Mercyhurst University,38,12,18,30,0.79,46,5
88,Charlie Gerard (C/RW),Minnesota State University (Mankato),42,12,18,30,0.71,22,15
89,Mitchell Vanderlaan (LW),Cornell University,36,11,19,30,0.83,8,5
90,Liam Pecararo (LW/RW),Northeastern University,37,11,19,30,0.81,10,7
91,Craig Martin (LW/C),Quinnipiac University,38,11,19,30,0.79,16,14
92,Tanner Laczynski (C),Ohio State University,27,10,20,30,1.11,14,2
93,Dylan Malmquist (LW),University of Notre Dame,40,10,20,30,0.75,6,11
94,Mathias Emilio Pettersen (C/LW),University of Denver,40,6,24,30,0.75,16,10
95,Jarid Lukosevicius (RW),University of Denver,40,19,10,29,0.73,20,20
96,Erik Brown (LW),RIT (Rochester Inst. of Tech.),37,18,11,29,0.78,23,-11
97,Chase Pearson (C/LW),University of Maine,34,16,13,29,0.85,34,21
98,Easton Brodzinski (RW/LW),St. Cloud State University,39,16,13,29,0.74,26,11
99,Ryan Walker (LW),Union College,39,15,14,29,0.74,6,12
100,Scott Conway (C),Providence College,42,15,14,29,0.69,38,8
101,Devin Brosseau (C/RW),Clarkson University,38,14,15,29,0.76,28,4
102,Chase Berger (C),Penn State University,39,14,15,29,0.74,8,8
103,Nikita Pavlychev (C),Penn State University,39,14,15,29,0.74,57,2
104,Marc Del Gaizo (D),UMass,41,13,16,29,0.71,26,31
105,Zach Evancho (W),Army (U.S. Military Academy),39,10,19,29,0.74,49,-20
106,Casey Dornbach (C/W),Harvard University,33,7,22,29,0.88,10,1
107,Scott Perunovich (D),University of Minnesota-Duluth,39,3,26,29,0.74,32,9
108,Quin Foreman (RW),Dartmouth College,34,13,15,28,0.82,8,2
109,Bobby Trivigno (LW),UMass,39,13,15,28,0.72,31,9
110,Tyler Madden (C),Northeastern University,36,12,16,28,0.78,8,5
111,Austin Alger (F),Canisius College,37,12,16,28,0.76,24,-8
112,Tanner Jago (D),Bentley University,37,9,19,28,0.76,18,17
113,Cooper Zech (D),Ferris State University,36,8,20,28,0.78,12,3
114,Mason Bergh (RW/LW),Colorado College,41,7,21,28,0.68,42,-12
115,Cole Hults (D),Penn State University,39,6,22,28,0.72,24,19
116,Brandon Fortunato (D),Quinnipiac University,26,5,23,28,1.08,2,15
117,Ioannis Kaldis (D),Cornell University,36,4,24,28,0.78,20,1
118,Jacob Bryson (D),Providence College,42,4,24,28,0.67,8,17
119,Austin Magera (C),Sacred Heart University,36,14,13,27,0.75,38,5
120,Karl El-Mir (C/LW),University of Connecticut,34,13,14,27,0.79,16,6
121,Austin Rueschhoff (F),Western Michigan University,36,13,14,27,0.75,48,6
122,Ryan Lohin (C),UMass-Lowell,33,12,15,27,0.82,12,7
123,Kyle Stephan (RW),American International College,37,11,16,27,0.73,12,8
124,Taylor Ward (RW),University of Nebraska-Omaha,35,9,18,27,0.77,18,-8
125,Eric Cooley (RW/LW),Niagara University,41,9,18,27,0.66,23,-4
126,Nolan Walker (C),St. Cloud State University,36,8,19,27,0.75,4,6
127,Jared Spooner (LW),Minnesota State University (Mankato),41,7,20,27,0.66,41,10
128,Ian Mitchell (D),University of Denver,39,6,21,27,0.69,18,18
129,Mikey Anderson (D),University of Minnesota-Duluth,40,6,21,27,0.68,18,22
130,Tobias Fladeby (LW/RW),American International College,40,18,8,26,0.65,23,3
131,Drew O'Connor (LW/RW),Dartmouth College,34,17,9,26,0.76,14,0
132,Ethen Frank (RW/C),Western Michigan University,34,15,11,26,0.76,29,1
133,Sean Dhooghe (RW),University of Wisconsin,37,15,11,26,0.70,19,-8
134,Brannon McManus (C/RW),University of Minnesota,36,14,12,26,0.72,14,4
135,Liam Morgan (RW),Union College,38,14,12,26,0.68,23,16
136,Cole Guttman (C/RW),University of Denver,41,14,12,26,0.63,18,16
137,Nick Hutchison (C/LW),Canisius College,34,13,13,26,0.76,47,3
138,Patrick Curry (C/LW),Boston University,38,13,13,26,0.68,32,2
139,Justin Kendall (F),Niagara University,41,12,14,26,0.63,6,1
140,Alex Riche (C),Princeton University,30,11,15,26,0.87,14,-5
141,Tommy Marchin (LW),Brown University,34,11,15,26,0.76,29,-6
142,Jake Lucchini (C/LW),Michigan Tech,38,11,15,26,0.68,14,-6
143,Josh Melnick (C),Miami University (Ohio),32,10,16,26,0.81,45,-2
144,Sammy Walker (C/RW),University of Minnesota,37,10,16,26,0.70,16,6
145,Jordan Kawaguchi (C),University of North Dakota,37,10,16,26,0.70,21,-6
146,Zach Jordan (RW),University of Nebraska-Omaha,36,9,17,26,0.72,42,-17
147,Michael Louria (RW),Robert Morris University,40,9,17,26,0.65,10,-14
148,Martin Mellberg (RW),American International College,41,9,17,26,0.63,20,0
149,Seamus Malone (C),University of Wisconsin,37,8,18,26,0.70,58,10
150,Aaron Thow (D),Clarkson University,39,8,18,26,0.67,20,10
151,Cameron Lee (D),Western Michigan University,37,7,19,26,0.70,53,10
152,Logan Hutsko (RW/C),Boston College,36,6,20,26,0.72,10,-7
153,Jáchym Kondelík (C/W),University of Connecticut,33,4,22,26,0.79,12,1
154,Alexander Wilkinson (D),Army (U.S. Military Academy),34,4,22,26,0.76,2,-2
155,Alec Rauhauser (D),Bowling Green State University,41,4,22,26,0.63,34,21
156,Bryan Yoon (D),Colorado College,41,3,23,26,0.63,19,-1
157,Nick Swaney (RW),University of Minnesota-Duluth,40,15,10,25,0.63,0,17
158,Lukas Craggs (LW),Bowling Green State University,35,13,12,25,0.71,118,18
159,Alex Whelan (RW),Quinnipiac University,38,13,12,25,0.66,14,15
160,Cam Donaldson (C),Cornell University,34,12,13,25,0.74,6,16
161,Jake Slaker (C),University of Michigan,35,11,14,25,0.71,2,-2
162,Gordie Green (C/RW),Miami University (Ohio),38,11,14,25,0.66,12,-8
163,Will Graber (C),Dartmouth College,33,10,15,25,0.76,36,0
164,Matthew Whittaker (RW),Mercyhurst University,35,10,15,25,0.71,24,2
165,Corey Mackin (C),Ferris State University,36,10,15,25,0.69,14,-7
166,Colin Saccoman (D),Lake Superior State University,37,10,15,25,0.68,57,17
167,Ethan De Jong (RW/LW),Quinnipiac University,38,10,15,25,0.66,8,12
168,Wyatt Kalynuk (D),University of Wisconsin,37,9,16,25,0.68,32,0
169,Ludvig Larsson (C),Penn State University,39,9,16,25,0.64,22,-4
170,Linus Weissbach (LW),University of Wisconsin,27,8,17,25,0.93,10,2
171,Tyce Thompson (RW/C),Providence College,42,8,17,25,0.60,20,12
172,Gage Torrel (F),Lake Superior State University,38,7,18,25,0.66,37,20
173,Connor Mackey (D),Minnesota State University (Mankato),42,7,18,25,0.60,55,15
174,Brennan Kapcheck (D),American International College,37,5,20,25,0.68,25,12
175,Ian Scheid (D),Minnesota State University (Mankato),42,5,20,25,0.60,22,16
176,Matt Koch (D),Air Force Academy,35,4,21,25,0.71,20,-3
177,Lewis Zerter-Gossage (RW/C),Harvard University,33,18,6,24,0.73,6,4
178,Dalton Hunter (RW/LW),Mercyhurst University,30,11,13,24,0.80,14,8
179,Chase Gresock (F),Merrimack College,34,11,13,24,0.71,26,-12
180,Nick Pastujov (C/LW),University of Michigan,36,11,13,24,0.67,56,-1
181,Liam Blackburn (F),University of New Hampshire,35,10,14,24,0.69,22,1
182,Grant Jozefek (RW),Northeastern University,38,10,14,24,0.63,26,1
183,Jack Drury (C),Harvard University,32,9,15,24,0.75,14,10
184,Steven Jandric (LW),University of Alaska-Fairbanks,36,9,15,24,0.67,71,-9
185,Peter Krieger (C/LW),University of Minnesota-Duluth,41,9,15,24,0.59,41,12
186,Nate Kallen (D),Ferris State University,36,7,17,24,0.67,6,2
187,Jimmy Mazza (D),Canisius College,36,6,18,24,0.67,49,-9
188,Jack Jacome (RW/LW),Clarkson University,39,6,18,24,0.62,8,4
189,Brogan Rafferty (D),Quinnipiac University,38,4,20,24,0.63,60,0
190,Dennis Cesana (D),Michigan State University,36,3,21,24,0.67,14,-1
191,Andrew Peeke (D),University of Notre Dame,40,3,21,24,0.60,24,-2
192,Zach Solow (C/RW),Northeastern University,39,15,8,23,0.59,20,4
193,Josh Dunne (C/LW),Clarkson University,32,14,9,23,0.72,14,14
194,Ryan Dmowski (LW/C),UMass-Lowell,37,14,9,23,0.62,16,5
195,Wyatt Bongiovanni (C/LW),Quinnipiac University,38,14,9,23,0.61,20,5
196,Ara Nazarian (LW/C),University of New Hampshire,33,12,11,23,0.70,20,-4
197,Kyle Haak (F),Air Force Academy,35,12,11,23,0.66,20,-6
198,Anthony Rinaldi (LW/RW),Union College,37,11,12,23,0.62,10,-2
199,Trevor Gooch (C/W),Colorado College,41,11,12,23,0.56,37,-6
200,Angus Crookshank (LW/RW),University of New Hampshire,36,10,13,23,0.64,6,3
201,Brayden Gelsinger (LW),Lake Superior State University,38,10,13,23,0.61,40,7
202,Dawson DiPietro (LW),Western Michigan University,33,9,14,23,0.70,28,-1
203,Julius Mattila (C),Boston College,34,9,14,23,0.68,6,0
204,Jason Cotton (C),Sacred Heart University,37,9,14,23,0.62,6,9
205,Brett Supinski (C/RW),Union College,38,9,14,23,0.61,16,-5
206,Noah Cates (LW),University of Minnesota-Duluth,40,9,14,23,0.58,33,12
207,Bobby McMann (C/LW),Colgate University,36,8,15,23,0.64,32,-15
208,Steven Ipri (F),Mercyhurst University,36,8,15,23,0.64,39,-6
209,Daniel Mantenuto (C),Robert Morris University,40,8,15,23,0.58,12,-11
210,Anthony Croston (F),Arizona State University,34,7,16,23,0.68,54,11
211,Nick Prkusic (F),Robert Morris University,38,7,16,23,0.61,34,-4
212,Jackson Cressey (F),Princeton University,31,6,17,23,0.74,8,-5
213,Luke Edgerton (F),Niagara University,39,6,17,23,0.59,22,8
214,Cameron Heath (D),Canisius College,37,4,19,23,0.62,38,4
215,Shawn McBride (C/D),American International College,41,4,19,23,0.56,10,-1
216,Jacob Hayhurst (C/LW),RPI (Rensselaer Polytech. Inst.),29,3,20,23,0.79,27,-6
217,Lukas Kälble (D),Lake Superior State University,37,2,21,23,0.62,8,17
218,Dominic Franco (RW/C),Army (U.S. Military Academy),38,14,8,22,0.58,62,-8
219,Kenny Hausinger (C),UMass-Lowell,37,13,9,22,0.59,12,-2
220,Michael Graham (F),University of Notre Dame,39,12,10,22,0.56,12,3
221,Evan Feno (F),Air Force Academy,32,11,11,22,0.69,13,-3
222,Charlie Combs (LW),Bemidji State University,38,11,11,22,0.58,24,-6
223,Alden Dupuis (F),RIT (Rochester Inst. of Tech.),35,10,12,22,0.63,10,16
224,Jack Adams (RW/C),Union College,38,10,12,22,0.58,29,13
225,Sebastian Vidmar (LW),Union College,39,10,12,22,0.56,30,-2
226,Dakota Joshua (LW/C),Ohio State University,32,9,13,22,0.69,67,4
227,Mitch Collett (C),College of the Holy Cross,35,9,13,22,0.63,26,-7
228,Carson Meyer (RW/LW),Ohio State University,36,9,13,22,0.61,26,4
229,Denis Smirnov (RW/LW),Penn State University,37,8,14,22,0.59,6,2
230,Stephen Baylis (LW/RW),Bowling Green State University,37,8,14,22,0.59,27,11
231,Jack Rathbone (D),Harvard University,33,7,15,22,0.67,8,13
232,Eric Israel (D),Robert Morris University,33,7,15,22,0.67,40,0
233,Brady Keeper (D),University of Maine,36,7,15,22,0.61,58,-8
234,Jake Gaudet (C),UMass,41,7,15,22,0.54,41,26
235,Derek Daschke (D),Miami University (Ohio),38,6,16,22,0.58,8,-2
236,K'Andre Miller (D),University of Wisconsin,26,5,17,22,0.85,18,7
237,Matt Miller (D),Ohio State University,36,5,17,22,0.61,8,2
238,Ashton Calder (F),Lake Superior State University,37,5,17,22,0.59,32,12
239,Marc Johnstone (RW/LW),Sacred Heart University,37,5,17,22,0.59,34,-2
240,Seamus Donohue (D),Michigan Tech,38,1,21,22,0.58,49,-5
241,Brian Halonen (LW/RW),Michigan Tech,35,12,9,21,0.60,26,1
242,Dallas Gerads (C/LW),Minnesota State University (Mankato),37,12,9,21,0.57,36,8
243,Brendan Hamblet (F),Bentley University,31,11,10,21,0.68,18,15
244,Cam Morrison (LW),University of Notre Dame,32,11,10,21,0.66,12,-2
245,Ronnie Hein (C),Ohio State University,35,11,10,21,0.60,22,3
246,Matt Hoover (LW),Canisius College,35,11,10,21,0.60,24,-6
247,Shane Bowers (C/W),Boston University,37,11,10,21,0.57,25,0
248,Joel Kocur (LW/C),American International College,39,11,10,21,0.54,61,5
249,Ryan Steele (F),Sacred Heart University,37,10,11,21,0.57,16,0
250,Ben Copeland (C),Colorado College,41,9,12,21,0.51,12,4
251,Max Kaufman (F),University of Vermont,29,8,13,21,0.72,12,9
252,Tristan Mullin (C/LW),Cornell University,34,8,13,21,0.62,34,9
253,Adam Brady (C/LW),Bemidji State University,37,8,13,21,0.57,8,-7
254,William Fällström (C/LW),Quinnipiac University,38,8,13,21,0.55,18,13
255,James Anderson (RW),Mercyhurst University,38,8,13,21,0.55,27,-7
256,Julian Napravnik (RW),Minnesota State University (Mankato),41,8,13,21,0.51,6,12
257,Spenser Young (D),Providence College,41,8,13,21,0.51,18,18
258,Tyler Busch (C),Arizona State University,34,7,14,21,0.62,71,-1
259,Brett Gruber (C),Arizona State University,35,7,14,21,0.60,18,4
260,Johnny Coughlin (D),College of the Holy Cross,36,7,14,21,0.58,32,-5
261,Grant Hutton (D),Miami University (Ohio),37,7,14,21,0.57,29,-5
262,Lincoln Griffin (LW),Northeastern University,39,7,14,21,0.54,22,20
263,Max Gildon (D),University of New Hampshire,31,6,15,21,0.68,45,-7
264,Ruslan Iskhakov (C/LW),University of Connecticut,32,6,15,21,0.66,20,1
265,Mike O'Leary (C),University of Notre Dame,39,6,15,21,0.54,18,5
266,Anthony Vincent (RW/C),College of the Holy Cross,35,5,16,21,0.60,39,4
267,Dean Stewart (D),University of Nebraska-Omaha,36,5,16,21,0.58,33,-5
268,Connor Sodergren (F),UMass-Lowell,37,5,16,21,0.57,34,13
269,Brandon Estes (D),Union College,39,5,16,21,0.54,10,9
270,Tommy Novak (C),University of Minnesota,38,4,17,21,0.55,4,-14
271,Kris Myllari (D),Penn State University,39,4,17,21,0.54,12,19
272,Charlie Kelleher (RW),University of New Hampshire,30,3,18,21,0.70,0,0
273,Corey Schueneman (D),Western Michigan University,37,3,18,21,0.57,8,11
274,Alexandre Payusov (RW),University of Connecticut,34,16,4,20,0.59,18,-1
275,Aaron Miller (F),Bemidji State University,32,11,9,20,0.63,52,1
276,Colin Theisen (C),University of Notre Dame,40,11,9,20,0.50,8,4
277,Denver Pierce (C),Northern Michigan University,34,10,10,20,0.59,18,4
278,Darien Craighead (RW/C),Northern Michigan University,36,10,10,20,0.56,33,-7
279,Sam Hentges (C/LW),St. Cloud State University,37,10,10,20,0.54,24,14
280,Nick Jones (C/RW),University of North Dakota,26,9,11,20,0.77,10,2
281,Cameron Wright (RW),Bowling Green State University,39,9,11,20,0.51,20,8
282,Gabriel Valenzuela (C),RIT (Rochester Inst. of Tech.),28,8,12,20,0.71,24,-15
283,Chad Krys (D),Boston University,30,8,12,20,0.67,12,-10
284,Jack Badini (C),Harvard University,33,8,12,20,0.61,16,1
285,Brendan Soucie (F),Army (U.S. Military Academy),36,8,12,20,0.56,12,-9
286,Reid Stefanson (C/LW),UMass-Lowell,36,8,12,20,0.56,33,1
287,Zach Giuttari (D),Brown University,34,7,13,20,0.59,13,8
288,Ryner Gorowsky (RW),Bentley University,35,7,13,20,0.57,44,10
289,Freddy Gerard (F),Ohio State University,36,7,13,20,0.56,6,1
290,Cody Milan (C/RW),Michigan State University,36,7,13,20,0.56,18,-9
291,Evan Giesler (F),Air Force Academy,36,7,13,20,0.56,18,-7
292,Coale Norris (LW),Ferris State University,36,7,13,20,0.56,55,-3
293,Tarek Baker (LW),University of Wisconsin,37,7,13,20,0.54,49,-6
294,Johnny Curran (RW/C),Niagara University,41,7,13,20,0.49,30,-14
295,Tristan Thompson (D),University of Alaska-Fairbanks,35,6,14,20,0.57,40,-10
296,Patrick Harper (C/LW),Boston University,38,6,14,20,0.53,6,2
297,Blake McLaughlin (LW/C),University of Minnesota,35,5,15,20,0.57,36,-3
298,Nick Perbix (D),St. Cloud State University,39,5,15,20,0.51,16,24
299,Greg Moro (D),Clarkson University,39,5,15,20,0.51,28,17
300,Josh Maniscalco (D),Arizona State University,35,4,16,20,0.57,22,12
301,Demetrios Koumontzis (LW/D),Arizona State University,35,4,16,20,0.57,36,7
302,David Farrance (D),Boston University,37,4,16,20,0.54,19,0
303,Mattias Göransson (D),UMass-Lowell,37,4,16,20,0.54,24,5
304,Josh Teves (D),Princeton University,30,3,17,20,0.67,20,-13
305,Joseph Cecconi (D),University of Michigan,36,3,17,20,0.56,26,-2
306,Dan Willett (D),RIT (Rochester Inst. of Tech.),38,3,17,20,0.53,43,-9
307,Karlis Cukste (D),Quinnipiac University,38,2,18,20,0.53,26,9
308,Dylan Hollman (LW),Arizona State University,35,12,7,19,0.54,8,14
309,Hans Gorowsky (F),University of Alabama-Huntsville,38,12,7,19,0.50,20,-13
310,Josh Norris (C/LW),University of Michigan,17,10,9,19,1.12,10,-2
311,Bobo Carpenter (LW/C),Boston University,27,10,9,19,0.70,24,-2
312,Mason Krueger (F),Army (U.S. Military Academy),34,10,9,19,0.56,30,2
313,Owen Sillinger (C/LW),Bemidji State University,38,10,9,19,0.50,34,0
314,Nick Rivera (C),Minnesota State University (Mankato),39,10,9,19,0.49,30,12
315,Brett Boeing (C),UMass,41,10,9,19,0.46,20,12
316,Michael Pastujov (LW),University of Michigan,31,9,10,19,0.61,4,8
317,Alex Jasiek (F),Dartmouth College,31,9,10,19,0.61,8,4
318,Shawn Cameron (LW/RW),RIT (Rochester Inst. of Tech.),38,9,10,19,0.50,35,3
319,Joseph Nardi (C/LW),Northern Michigan University,39,9,10,19,0.49,15,-1
320,Riley Tufte (LW/RW),University of Minnesota-Duluth,42,9,10,19,0.45,30,2
321,Christopher Berger (LW),Brown University,29,8,11,19,0.66,47,-4
322,Jackson Pierson (C),University of New Hampshire,32,8,11,19,0.59,4,1
323,Brent Beaudoin (C),Brown University,34,8,11,19,0.56,4,5
324,Oliver Wahlstrom (RW/LW),Boston College,36,8,11,19,0.53,28,-6
325,Kylar Hope (F),University of Alaska-Fairbanks,36,8,11,19,0.53,46,-11
326,Matt Filipe (C/LW),Northeastern University,37,8,11,19,0.51,18,5
327,Jake Jaremko (LW/C),Minnesota State University (Mankato),37,7,12,19,0.51,18,11
328,Dylan Samberg (D),University of Minnesota-Duluth,39,7,12,19,0.49,35,22
329,Cole Koepke (LW/RW/RW),University of Minnesota-Duluth,42,7,12,19,0.45,14,14
330,Chris Wilkie (RW/LW),Colorado College,20,6,13,19,0.95,10,5
331,Spencer Trapp (D),College of the Holy Cross,36,6,13,19,0.53,34,-2
332,Gustaf Westlund (C/W),Ohio State University,25,5,14,19,0.76,26,1
333,Grant Meyer (RW),Canisius College,31,5,14,19,0.61,61,-2
334,Brett Stapley (C),University of Denver,32,5,14,19,0.59,35,9
335,Carson Gicewicz (C),St. Lawrence University,31,4,15,19,0.61,18,-7
336,Tristan Crozier (F),Brown University,34,4,15,19,0.56,8,-3
337,Mike Lee (D),Sacred Heart University,35,4,15,19,0.54,27,-2
338,Ottoville Leppänen (F),RPI (Rensselaer Polytech. Inst.),36,4,15,19,0.53,4,-2
339,Matt Nuttle (D),Cornell University,36,4,15,19,0.53,16,18
340,Peter DiLiberatore (D),Quinnipiac University,38,3,16,19,0.50,38,22
341,Kieran Durgan (F),Air Force Academy,36,12,6,18,0.50,8,-4
342,Jordan Kaplan (RW/C),Sacred Heart University,35,11,7,18,0.51,39,-1
343,Grant Cruikshank (C/LW),Colorado College,40,11,7,18,0.45,23,-15
344,Greg Printz (LW/RW),Providence College,42,11,7,18,0.43,34,6
345,Kevin Fitzgerald (C),St. Cloud State University,26,10,8,18,0.69,14,13
346,Mike Laffin (F),College of the Holy Cross,36,10,8,18,0.50,10,-18
347,Nick Boyagian (F),Sacred Heart University,29,9,9,18,0.62,12,6
348,Matt Tugnutt (LW/C),Sacred Heart University,30,9,9,18,0.60,8,-4
349,Austin McIlmurray (RW),Sacred Heart University,33,9,9,18,0.55,31,1
350,Jack Poehling (C/LW),St. Cloud State University,35,9,9,18,0.51,28,11
351,Sam Sternschein (LW),Penn State University,39,9,9,18,0.46,10,-3
352,Taylor Best (LW),Mercyhurst University,26,8,10,18,0.69,48,3
353,John Schilling (F),Bowling Green State University,31,8,10,18,0.58,20,12
354,Brady Tomlak (C),Air Force Academy,34,8,10,18,0.53,52,-2
355,Robbie DeMontis (LW),Yale University,28,7,11,18,0.64,4,7
356,Derek Petti (F),Merrimack College,28,7,11,18,0.64,43,-2
357,Brenden Locke (C),Cornell University,31,7,11,18,0.58,6,11
358,Zac Risteau (C/LW),St. Lawrence University,31,7,11,18,0.58,23,-10
359,Griffin Loughran (F),Northern Michigan University,35,7,11,18,0.51,72,1
360,Matt Kiersted (D),University of North Dakota,36,7,11,18,0.50,35,2
361,Will Garin (RW),Bentley University,31,6,12,18,0.58,12,4
362,Tyler Irvine (RW),Merrimack College,34,6,12,18,0.53,17,-18
363,Marcus Vela (C),University of New Hampshire,36,6,12,18,0.50,34,0
364,Will Reilly (D),RPI (Rensselaer Polytech. Inst.),33,5,13,18,0.55,16,-1
365,Derek Lodermeier (LW),University of Vermont,33,5,13,18,0.55,18,5
366,Max Zimmer (LW),University of Wisconsin,34,5,13,18,0.53,12,4
367,Ty Farmer (D),UMass,40,5,13,18,0.45,26,8
368,Nick Wolff (D),University of Minnesota-Duluth,42,5,13,18,0.43,80,19
369,Brendan Harris (C/LW),Bemidji State University,31,4,14,18,0.58,6,-8
370,Johnathan Kovacevic (D),Merrimack College,31,4,14,18,0.58,14,-10
371,Jack Sadek (D),University of Minnesota,38,4,14,18,0.47,36,0
372,Jacob Nordqvist (D),Lake Superior State University,38,3,15,18,0.47,16,17
373,Luka Maver (C),American International College,41,11,6,17,0.41,14,2
374,John Wiitala (LW),Ohio State University,36,9,8,17,0.47,14,9
375,Tim Doherty (C/LW),University of Maine,36,9,8,17,0.47,16,-14
376,Alex Berardinelli (C/LW),Colorado College,40,9,8,17,0.43,12,8
377,Vito Bavaro (RW),Sacred Heart University,33,8,9,17,0.52,26,0
378,Eduards Tralmaks (W/C),University of Maine,36,8,9,17,0.47,22,10
379,Colin Bilek (RW),Army (U.S. Military Academy),38,7,10,17,0.45,12,-4
380,Nick Poehling (C/LW),St. Cloud State University,39,7,10,17,0.44,24,10
381,Liam Coughlin (C/LW),University of Vermont,29,6,11,17,0.59,16,-6
382,Justin Pearson (LW),Yale University,33,6,11,17,0.52,18,-5
383,Tommaso Bucci (LW),Mercyhurst University,37,6,11,17,0.46,23,3
384,Dylan Mills (C),Niagara University,40,6,11,17,0.43,56,-9
385,Colton Poolman (D),University of North Dakota,35,5,12,17,0.49,4,7
386,Jacob Bernard-Docker (D),University of North Dakota,36,5,12,17,0.47,6,-3
387,Christiano Versich (RW),Colorado College,40,5,12,17,0.43,8,-9
388,Bo Hanson (D),St. Lawrence University,37,4,13,17,0.46,22,-21
389,Charles Levesque (C),UMass-Lowell,37,4,13,17,0.46,27,-1
390,Liam Clare (D),Sacred Heart University,35,1,16,17,0.49,20,7
391,Zachary Mirageas (D),Air Force Academy,35,1,16,17,0.49,51,-1
392,Patrik Demel (D),American International College,41,1,16,17,0.41,10,15
393,Walker Duehr (RW),Minnesota State University (Mankato),34,10,6,16,0.47,24,14
394,Brendan van Riemsdyk (C),University of New Hampshire,36,10,6,16,0.44,18,-3
395,Karch Bachman (LW/C),Miami University (Ohio),38,10,6,16,0.42,33,-11
396,Patrick Schule (F),Northeastern University,38,10,6,16,0.42,43,6
397,Joey Cipollone (C),University of Vermont,34,9,7,16,0.47,9,0
398,Jonny Evans (F),University of Connecticut,22,8,8,16,0.73,8,5
399,Ben Sokay (C),Niagara University,34,8,8,16,0.47,12,1
400,Ty Amonte (RW),Boston University,37,8,8,16,0.43,41,-6
401,Colin Staub (F),University of Denver,41,8,8,16,0.39,4,3
402,Josh French (F),Minnesota State University (Mankato),41,8,8,16,0.39,4,13
403,Hugo Reinhardt (C),American International College,23,7,9,16,0.70,18,3
404,Alex Esposito (RW),University of Vermont,28,7,9,16,0.57,4,-11
405,Ben Freeman (RW/C),University of Connecticut,34,7,9,16,0.47,27,-9
406,Todd Burgess (C/W),RPI (Rensselaer Polytech. Inst.),36,7,9,16,0.44,31,-10
407,Will Calverley (C),RIT (Rochester Inst. of Tech.),37,7,9,16,0.43,48,3
408,Christopher Brown (C/RW),Boston College,39,7,9,16,0.41,14,-14
409,Nick Lalonde (RW),Robert Morris University,40,7,9,16,0.40,8,0
410,Reggie Lutz (RW),Minnesota State University (Mankato),40,7,9,16,0.40,12,1
411,Max Kalter (C),University of Connecticut,34,6,10,16,0.47,10,-8
412,Sampo Ranta (LW/RW),University of Minnesota,36,6,10,16,0.44,29,-1
413,Colton Leiter (D/C),University of Alaska-Fairbanks,36,6,10,16,0.44,36,-6
414,Nick Master (C),UMass-Lowell,37,6,10,16,0.43,10,2
415,Jay Dickman (C/LW),Bemidji State University,38,6,10,16,0.42,16,-9
416,Aarne Talvitie (C/LW),Penn State University,17,5,11,16,0.94,2,1
417,Neil Robinson (LW),College of the Holy Cross,27,5,11,16,0.59,10,-1
418,Kevin O'Neil (RW/LW),Yale University,31,5,11,16,0.52,10,-10
419,Max Gottlieb (D),Brown University,34,5,11,16,0.47,22,4
420,John Picking (F),Northeastern University,35,5,11,16,0.46,4,16
421,Cole Smith (LW),University of North Dakota,37,5,11,16,0.43,50,12
422,Sami Tavernier (RW),Merrimack College,33,4,12,16,0.48,43,-10
423,Jerad Rosburg (D),Michigan State University,36,4,12,16,0.44,33,1
424,Matt Hellickson (D),University of Notre Dame,40,4,12,16,0.40,16,5
425,Michael Davies (D),University of Denver,41,4,12,16,0.39,24,16
426,Brian Hawkinson (RW),Miami University (Ohio),34,3,13,16,0.47,20,-2
427,Vasili Kolias (D),Union College,37,3,13,16,0.43,10,4
428,Ryan Shea (D),Northeastern University,39,3,13,16,0.41,12,23
429,Connor Yau (D/F),Dartmouth College,34,2,14,16,0.47,6,10
430,Michael Regush (C),Cornell University,36,12,3,15,0.42,10,3
431,Cade Gleekel (W),St. Lawrence University,37,9,6,15,0.41,24,-10
432,Nick Cardelli (C/RW),Bemidji State University,37,9,6,15,0.41,35,3
433,Wade Allison (RW/LW),Western Michigan University,22,8,7,15,0.68,20,6
434,Reed Robinson (F),Niagara University,32,8,7,15,0.47,8,-6
435,Max Coatta (RW/C),Minnesota State University (Mankato),33,8,7,15,0.45,16,1
436,Beau Starrett (C/LW),Cornell University,36,8,7,15,0.42,43,4
437,Will Johnson (F),University of Wisconsin,37,8,7,15,0.41,8,14
438,Rhett Gardner (C/LW),University of North Dakota,37,8,7,15,0.41,71,-4
439,Justin Addamo (C/RW),Robert Morris University,39,8,7,15,0.38,51,-14
440,Philip Lagunov (C),UMass,40,8,7,15,0.38,14,11
441,Sam Craggs (LW/RW),Bowling Green State University,41,8,7,15,0.37,51,13
442,Kobe Roth (F),University of Minnesota-Duluth,42,8,7,15,0.36,2,4
443,Patrick Grasso (RW),University of New Hampshire,29,7,8,15,0.52,0,-6
444,Troy Conzo (F),Colorado College,34,7,8,15,0.44,8,-6
445,Peter Crinella (C),College of the Holy Cross,35,7,8,15,0.43,23,-7
446,Connor Wilson (LW),UMass-Lowell,36,7,8,15,0.42,14,3
447,Jakov Novak (LW/C),Bentley University,37,7,8,15,0.41,14,1
448,Justin Cole (F),American International College,40,7,8,15,0.38,21,-6
449,Nathan Burke (C/LW),University of Minnesota,26,6,9,15,0.58,6,5
450,Frédéric Grégoire (F),Harvard University,33,6,9,15,0.45,14,9
451,Trenton Bliss (LW/C),Michigan Tech,34,6,9,15,0.44,10,-2
452,Jack Becker (C/RW),University of Michigan,36,6,9,15,0.42,18,-8
453,Roman Ahcan (LW/C),University of Wisconsin,37,6,9,15,0.41,58,1
454,Craig Pefley (C),Ferris State University,29,5,10,15,0.52,45,-3
455,Evan Smith (C/LW),Yale University,32,5,10,15,0.47,35,-1
456,Carl Hesler (C/LW),Dartmouth College,34,5,10,15,0.44,16,-1
457,Parker Foo (LW),Union College,35,5,10,15,0.43,30,8
458,Greyson Reitmeier (LW/C),Michigan Tech,37,5,10,15,0.41,29,-4
459,Tyler Ward (LW),University of Denver,38,5,10,15,0.39,12,6
460,Kurt Gosselin (D),University of Alabama-Huntsville,25,4,11,15,0.60,48,-2
461,Matt Baker (C),Dartmouth College,32,4,11,15,0.47,14,1
462,Josh McKechney (F),Colgate University,36,4,11,15,0.42,19,-7
463,Jack Gorniak (LW/C),University of Wisconsin,37,4,11,15,0.41,16,-8
464,Chris Jandric (D),University of Alaska-Fairbanks,28,3,12,15,0.54,42,-1
465,Jonathan Gruden (LW/RW),Miami University (Ohio),38,3,12,15,0.39,12,-19
466,Michael Kim (D),Boston College,39,3,12,15,0.38,8,-5
467,Kevin Kerr (D),Penn State University,35,2,13,15,0.43,19,-14
468,Oliver Chau (C),UMass,35,9,5,14,0.40,8,5
469,Walker Sommer (C),Air Force Academy,35,9,5,14,0.40,12,0
470,Brendan Robbins (RW),University of Maine,36,9,5,14,0.39,24,-1
471,Chase Zieky (RW/LW),RPI (Rensselaer Polytech. Inst.),21,8,6,14,0.67,6,-3
472,David Jankowski (C/RW),St. Lawrence University,37,8,6,14,0.38,6,-12
473,Alec Broetzman (LW),Michigan Tech,38,8,6,14,0.37,12,-4
474,Jackson Cates (C/LW),University of Minnesota-Duluth,39,8,6,14,0.36,14,3
475,Alec Marsh (LW/C),Penn State University,34,7,7,14,0.41,18,-6
476,P.J. Marrocco (F),Arizona State University,35,7,7,14,0.40,10,7
477,Tristan Keck (LW),University of Nebraska-Omaha,36,7,7,14,0.39,12,-3
478,Bauer Neudecker (F),University of Alabama-Huntsville,38,7,7,14,0.37,2,-12
479,Jack Jeffers (F),University of Alabama-Huntsville,38,7,7,14,0.37,44,-10
480,Frédéric Létourneau (C),Bowling Green State University,41,7,7,14,0.34,30,9
481,Jeff Malott (LW),Cornell University,27,6,8,14,0.52,27,1
482,Jason Tackett (LW),Ferris State University,28,6,8,14,0.50,10,1
483,Jack St. Ivany (D),Yale University,30,6,8,14,0.47,20,8
484,Alex Brink (C),Brown University,31,6,8,14,0.45,63,7
485,Jacob Schmidt-Svejstrup (RW),University of Maine,33,6,8,14,0.42,29,0
486,Michael Ederer (LW),St. Lawrence University,34,6,8,14,0.41,2,-15
487,Mark Senden (C/LW),University of North Dakota,36,6,8,14,0.39,24,17
488,Keenan Suthers (LW),St. Lawrence University,30,5,9,14,0.47,16,-11
489,Colin Burston (LW),Brown University,31,5,9,14,0.45,29,5
490,Chase Blackmun (D),UMass-Lowell,32,5,9,14,0.44,2,9
491,Quinn Preston (F),Ohio State University,35,5,9,14,0.40,14,3
492,Dakota Raabe (LW),University of Michigan,35,5,9,14,0.40,29,0
493,Ryan Barrow (RW),University of Denver,37,5,9,14,0.38,32,10
494,Austin Beaulieu (RW),University of Alabama-Huntsville,38,5,9,14,0.37,22,-9
495,Will Cullen (D),Bowling Green State University,31,4,10,14,0.45,14,9
496,Alex Smith (D/RW),Michigan Tech,33,4,10,14,0.42,14,-18
497,Patrick Shea (C),University of Maine,35,4,10,14,0.40,42,-4
498,Janis Jaks (D),American International College,38,4,10,14,0.37,12,-12
499,Madison Dunn (F),University of Alabama-Huntsville,38,4,10,14,0.37,14,-14
500,Connor McCarthy (D),Clarkson University,39,4,10,14,0.36,8,2
501,Stanislav Demin (D),University of Denver,41,4,10,14,0.34,14,19
502,Chris Dodero (C/LW),American International College,34,3,11,14,0.41,8,6
503,Wyatt Newpower (D),University of Connecticut,34,3,11,14,0.41,14,-16
504,Christian Rajic (C),University of Alabama-Huntsville,34,3,11,14,0.41,22,-5
505,Jordan Sandhu (C),Arizona State University,35,3,11,14,0.40,4,7
506,Hampus Eriksson (C/W),Lake Superior State University,36,3,11,14,0.39,10,1
507,Zach Osburn (D),Michigan State University,36,3,11,14,0.39,28,-2
508,Dillon Eichstadt (D),Bemidji State University,36,3,11,14,0.39,37,15
509,Niko Hildenbrand (F),UMass,37,3,11,14,0.38,29,3
510,Paul DeNaples (D),Penn State University,39,2,12,14,0.36,6,31
511,Casey Fitzgerald (D),Boston College,39,2,12,14,0.36,26,-6
512,Mario Ferraro (D),UMass,41,2,12,14,0.34,23,6
513,Matt Stief (D),Canisius College,34,0,14,14,0.41,2,-9
514,Nicolas Luka (D),American International College,35,0,14,14,0.40,14,0
515,Kevin Darrar (F),College of the Holy Cross,35,8,5,13,0.37,16,-3
516,Brady Wiffen (C),RPI (Rensselaer Polytech. Inst.),35,8,5,13,0.37,18,-12
517,Michael Zuffante (F),Bentley University,34,7,6,13,0.38,8,4
518,Hunter Wendt (F),Ferris State University,34,7,6,13,0.38,45,-3
519,Taylor Schneider (LW),Bowling Green State University,40,7,6,13,0.33,12,10
520,Nicolas Erb Ekholm (C/RW),University of Alaska-Anchorage,33,6,7,13,0.39,14,-24
521,Vladislav Dzhioshvili (C),University of Vermont,33,6,7,13,0.39,28,-5
522,Kevin Conley (LW/C),University of Nebraska-Omaha,35,6,7,13,0.37,22,-13
523,Jack McBain (C/LW),Boston College,35,6,7,13,0.37,39,-3
524,Luke Morgan (LW),University of Michigan,36,6,7,13,0.36,6,0
525,Ryan Garvey (LW),St. Lawrence University,37,6,7,13,0.35,20,-16
526,Trevor Fidler (C),Army (U.S. Military Academy),37,6,7,13,0.35,24,-6
527,Henry Bowlby (LW/C),Harvard University,29,5,8,13,0.45,33,1
528,Matthew O'Donnell (D),University of Vermont,34,5,8,13,0.38,18,1
529,Joshua Ess (D),University of Wisconsin,37,5,8,13,0.35,14,2
530,Alexei Solovyov (D),Bentley University,37,5,8,13,0.35,39,-3
531,Tyler Nanne (D),University of Minnesota,38,5,8,13,0.34,22,2
532,Jaakko Heikkinen (F),University of Denver,41,5,8,13,0.32,10,6
533,Vincent Desharnais (D),Providence College,42,5,8,13,0.31,32,22
534,Nick Halloran (RW),Colorado College,20,4,9,13,0.65,8,-5
535,Jimmy Lambert (RW/C),University of Michigan,31,4,9,13,0.42,10,1
536,Austin Lemieux (RW),Arizona State University,31,4,9,13,0.42,12,2
537,Ty Readman (C),Northern Michigan University,34,4,9,13,0.38,6,-1
538,Kobe Walker (RW),RIT (Rochester Inst. of Tech.),34,4,9,13,0.38,8,-4
539,Dylan Steman (C),Michigan Tech,37,4,9,13,0.35,24,-4
540,Jake Stevens (D),St. Lawrence University,29,3,10,13,0.45,14,-17
541,Brendan McKay (LW),Lake Superior State University,36,3,10,13,0.36,12,6
542,Jack Jenkins (C/RW),University of Notre Dame,40,3,10,13,0.33,8,-2
543,Tyson McLellan (C),University of Denver,40,3,10,13,0.33,32,10
544,Baker Shore (RW),Harvard University,33,2,11,13,0.39,16,3
545,Keegan Ford (D),Michigan Tech,37,2,11,13,0.35,8,-3
546,Josh McDougall (D),Mercyhurst University,38,2,11,13,0.34,12,-4
547,Tory Dello (D),University of Notre Dame,40,2,11,13,0.33,26,10
548,Chris Harpur (D),Niagara University,41,2,11,13,0.32,55,1
549,Ben Mirageas (D),Providence College,42,2,11,13,0.31,22,-7
550,Jacob Levin (D),Air Force Academy,36,1,12,13,0.36,8,-13
551,Jordan Harris (D),Northeastern University,39,1,12,13,0.33,8,21
552,Justin Jallen (F),Brown University,33,8,4,12,0.36,14,2
553,Jacob Kauppila (LW),Bentley University,33,7,5,12,0.36,22,-1
554,Gavin Gould (C/LW),Michigan Tech,34,7,5,12,0.35,12,-8
555,Brock Caufield (RW),University of Wisconsin,37,7,5,12,0.32,4,2
556,Mick Messner (LW),University of Wisconsin,37,7,5,12,0.32,12,-2
557,Tanner Laderoute (RW/C),University of Minnesota-Duluth,38,7,5,12,0.32,22,3
558,J.D. Dudek (C),Boston College,39,7,5,12,0.31,26,-4
559,Logan Ferguson (RW),College of the Holy Cross,21,5,7,12,0.57,16,-3
560,Jeff Losurdo (F),Dartmouth College,31,5,7,12,0.39,6,-3
561,Jake Transit (F),Ferris State University,34,5,7,12,0.35,28,-1
562,Mattias Samuelsson (D),Western Michigan University,35,5,7,12,0.34,37,3
563,Gabe Bast (D),University of North Dakota,36,5,7,12,0.33,49,7
564,Ethan Somoza (LW),Bemidji State University,38,5,7,12,0.32,8,13
565,Frankie Melton (LW),Ferris State University,29,4,8,12,0.41,14,1
566,Logan Lambdin (LW),Michigan State University,36,4,8,12,0.33,27,-7
567,Ty Emberson (D),University of Wisconsin,37,4,8,12,0.32,10,6
568,Casey Gilling (C),Miami University (Ohio),38,4,8,12,0.32,24,-8
569,Colton Kerfoot (F),Harvard University,33,3,9,12,0.36,8,7
570,Luke Bafia (D),Western Michigan University,36,3,9,12,0.33,24,6
571,Alec McCrea (D),Cornell University,36,3,9,12,0.33,26,8
572,Eric Williams (D),Northeastern University,39,3,9,12,0.31,14,7
573,Nick Austin (D),Colgate University,32,2,10,12,0.38,18,-14
574,Matt Riggleman (F),Bentley University,34,1,11,12,0.35,14,3
575,Alex Mehnert (D),Air Force Academy,36,1,11,12,0.33,24,-2
576,Ryan Jones (D),University of Nebraska-Omaha,36,0,12,12,0.33,41,-32
577,Alec Mahalak (D),Miami University (Ohio),38,0,12,12,0.32,12,-8
578,Ross Armour (C/RW),Bemidji State University,38,0,12,12,0.32,22,8
579,Trevor Stone (C/LW),Air Force Academy,34,9,2,11,0.32,20,-7
580,Max Newton (C/RW),University of Alaska-Fairbanks,32,8,3,11,0.34,16,-6
581,Ryan Siroky (F),Miami University (Ohio),38,8,3,11,0.29,8,-3
582,Joe Wegwerth (RW/LW),University of Notre Dame,12,7,4,11,0.92,10,5
583,Patrick Polino (C),RPI (Rensselaer Polytech. Inst.),24,7,4,11,0.46,23,-7
584,Scott Reedy (C),University of Minnesota,34,7,4,11,0.32,10,-3
585,Brendon Kearney (LW),Ohio State University,36,7,4,11,0.31,4,-3
586,Matthew Freytag (LW),University of Wisconsin,36,7,4,11,0.31,16,-5
587,Erik Middendorf (LW),Colorado College,41,7,4,11,0.27,6,-3
588,Lucas Finner (LW),Ferris State University,26,6,5,11,0.42,48,-12
589,Vimal Sukumaran (RW),Providence College,32,6,5,11,0.34,45,0
590,Michael Floodstrand (RW),Harvard University,33,6,5,11,0.33,8,6
591,Tyler Cline (C/LW),University of Alaska-Fairbanks,33,6,5,11,0.33,40,-7
592,Patrick Kramer (C),Merrimack College,34,6,5,11,0.32,28,-3
593,Kyle Marino (C/D),University of Alaska-Fairbanks,35,6,5,11,0.31,64,-12
594,Steven Ruggiero (D),Lake Superior State University,37,6,5,11,0.30,72,8
595,Jason O'Neill (F),Providence College,42,6,5,11,0.26,8,9
596,Curtis Hall (C),Yale University,24,5,6,11,0.46,16,1
597,Brian Rigali (F),University of Connecticut,29,5,6,11,0.38,20,-4
598,Mitchell Smith (LW),Yale University,30,5,6,11,0.37,6,6
599,Kale Howarth (LW/C),University of Connecticut,32,5,6,11,0.34,31,-10
600,Adam Dauda (C),Colgate University,34,5,6,11,0.32,2,-15
601,Trevor Cosgrove (D),Colgate University,36,5,6,11,0.31,8,-23
602,Les Lancaster (D),University of Denver,37,5,6,11,0.30,33,5
603,Matt Barry (F),College of the Holy Cross,13,4,7,11,0.85,14,-10
604,Collin Rutherford (C),Dartmouth College,33,4,7,11,0.33,6,2
605,Paul Washe (C),Western Michigan University,33,4,7,11,0.33,23,-5
606,Shane Sellar (F),Dartmouth College,34,4,7,11,0.32,12,2
607,Tim Theocharidis (D),Bowling Green State University,34,4,7,11,0.32,16,9
608,Will Riedell (D),Lake Superior State University,35,4,7,11,0.31,6,9
609,Dominick Mersch (C),University of Wisconsin,35,4,7,11,0.31,47,-1
610,Logan Cockerill (LW/RW),Boston University,37,4,7,11,0.30,33,1
611,Tony Bretzman (D),Northern Michigan University,38,4,7,11,0.29,26,14
612,Greg Campbell (D),Union College,38,4,7,11,0.29,40,7
613,Tyler Weiss (LW/C),University of Nebraska-Omaha,25,3,8,11,0.44,37,-4
614,Kyle Hallbauer (D),RPI (Rensselaer Polytech. Inst.),30,3,8,11,0.37,10,-13
615,Ludvig Hoff (LW),University of North Dakota,31,3,8,11,0.35,6,4
616,Noah Bauld (C),Cornell University,32,3,8,11,0.34,8,3
617,Jade Miller (LW),University of Minnesota-Duluth,33,3,8,11,0.33,8,8
618,John Marino (D),Harvard University,33,3,8,11,0.33,20,-3
619,Chandler Lindstrand (D),Yale University,27,2,9,11,0.41,6,6
620,Chad Staley (C),University of Alaska-Fairbanks,33,2,9,11,0.33,6,-7
621,Craig Puffer (LW),University of Vermont,33,2,9,11,0.33,8,-7
622,Tyler Welsh (C/RW),Yale University,33,2,9,11,0.33,14,-8
623,Alexis Binner (D),University of Maine,33,2,9,11,0.33,16,5
624,Ian Edmondson (D),Canisius College,34,2,9,11,0.32,12,-8
625,Wyatt Ege (D),Ohio State University,36,2,9,11,0.31,20,-1
626,Colin Swoyer (D),Michigan Tech,36,2,9,11,0.31,28,-6
627,Jordan Schneider (D),Clarkson University,39,2,9,11,0.28,41,15
628,Jack Summers (D),University of Michigan,29,1,10,11,0.38,6,2
629,Tony Stillwell (D),Brown University,30,1,10,11,0.37,8,1
630,Philip Alftberg (D),St. Lawrence University,34,1,10,11,0.32,26,-22
631,Alex Stevens (D),Penn State University,35,1,10,11,0.31,43,1
632,Evan Wisocky (C),University of Connecticut,30,0,11,11,0.37,6,-7
633,Kasper Kotkansalo (D),Boston University,38,0,11,11,0.29,16,-8
634,Chris Pohlkamp (D),Bowling Green State University,41,0,11,11,0.27,20,10
635,Nolan Moyle (C/RW),University of Michigan,30,7,3,10,0.33,30,1
636,Jeremiah Luedtke (C/RW),University of Alaska-Anchorage,33,7,3,10,0.30,16,-15
637,John Snodgrass (C),Colgate University,28,6,4,10,0.36,4,-6
638,Tommy Parrottino (F),Michigan Tech,30,6,4,10,0.33,6,-1
639,Aidan Spellacy (F),Robert Morris University,30,6,4,10,0.33,25,3
640,Derek Topatigh (D),Princeton University,30,6,4,10,0.33,33,2
641,Christopher Theodore (LW),American International College,34,6,4,10,0.29,12,-7
642,Kris Spriggs (LW),Niagara University,35,6,4,10,0.29,6,-1
643,Anthony Callin (RW/D),Clarkson University,35,6,4,10,0.29,14,-4
644,Niko Kovachis (D),Niagara University,35,6,4,10,0.29,26,-5
645,Anthony Del Gaizo (LW/C),UMass,37,6,4,10,0.27,24,12
646,Félix Chamberland (LW),Canisius College,22,5,5,10,0.45,8,-5
647,Grant Mismash (LW/C),University of North Dakota,24,5,5,10,0.42,27,-3
648,Nick Jermain (RW),Quinnipiac University,25,5,5,10,0.40,12,4
649,Scott Corbett (C),Miami University (Ohio),32,5,5,10,0.31,24,-5
650,Filips Buncis (C),Arizona State University,33,5,5,10,0.30,6,-4
651,Grant Hebert (C),Robert Morris University,33,5,5,10,0.30,39,-17
652,Daniel Haider (F),Army (U.S. Military Academy),34,5,5,10,0.29,8,-9
653,Drew Worrad (C),Western Michigan University,34,5,5,10,0.29,10,-1
654,Sean Harrison (RW),Union College,37,5,5,10,0.27,4,2
655,Christopher Klack (C/W),Clarkson University,37,5,5,10,0.27,14,5
656,Cameron Crotty (D),Boston University,38,5,5,10,0.26,33,2
657,Alex Barber (F),Bowling Green State University,40,5,5,10,0.25,35,-2
658,Jakub Lacka (LW),RPI (Rensselaer Polytech. Inst.),28,4,6,10,0.36,10,-7
659,Sam Saliba (F),Michigan State University,36,4,6,10,0.28,12,-20
660,Garrett Van Wyhe (C),University of Michigan,36,4,6,10,0.28,34,5
661,Connor James (D),University of Alabama-Huntsville,38,4,6,10,0.26,14,-19
662,Nick Farmer (F),Niagara University,41,4,6,10,0.24,20,-11
663,Cole Gallant (C),Western Michigan University,26,3,7,10,0.38,4,11
664,Nathan Krusko (C),Harvard University,33,3,7,10,0.30,2,2
665,Marly Quince (C),Clarkson University,34,3,7,10,0.29,25,5
666,Peter Tischke (D),University of Wisconsin,36,3,7,10,0.28,34,3
667,Hayden Shaw (D),University of North Dakota,37,3,7,10,0.27,20,11
668,Edwin Hookenson (D),Minnesota State University (Mankato),42,3,7,10,0.24,31,13
669,Maxim Andreev (C/LW),Cornell University,22,2,8,10,0.45,10,4
670,Oskar Andrén (RW),Ferris State University,24,2,8,10,0.42,12,-9
671,Jesper Öhrvall (C/RW),University of Alabama-Huntsville,32,2,8,10,0.31,14,-13
672,Seth Barton (D),UMass-Lowell,33,2,8,10,0.30,25,6
673,Nick Blankenburg (D),University of Michigan,34,2,8,10,0.29,12,11
674,Cam Knight (D),University of Alabama-Huntsville,37,2,8,10,0.27,24,-14
675,Jacob Pivonka (C),University of Notre Dame,40,2,8,10,0.25,25,1
676,Michael Callahan (D),Providence College,41,2,8,10,0.24,10,19
677,Louie Roehl (D),University of Minnesota-Duluth,42,2,8,10,0.24,40,14
678,Ben Finkelstein (D),Boston College,22,1,9,10,0.45,6,-6
679,Sam Morton (C/LW),Union College,29,1,9,10,0.34,4,0
680,Jacob Paganelli (RW),Princeton University,30,1,9,10,0.33,12,0
681,Clayton Phillips (D),University of Minnesota,34,1,9,10,0.29,20,-12
682,Spencer Meier (D),St. Cloud State University,38,1,9,10,0.26,32,2
683,Matthew Berkovitz (D),Army (U.S. Military Academy),39,1,9,10,0.26,8,-9
684,Jack McNeely (D),Minnesota State University (Mankato),42,1,9,10,0.24,22,27
685,Jordan Seyfert (C),Merrimack College,29,0,10,10,0.34,18,-4
686,Dalton Skelly (D),College of the Holy Cross,35,0,10,10,0.29,8,-3
687,Nikolas Koberstein (D),University of Alaska-Fairbanks,35,0,10,10,0.29,60,-3
688,Alexander Robert (D),Robert Morris University,38,0,10,10,0.26,47,9
689,Alex Steeves (LW/C),University of Notre Dame,39,7,2,9,0.23,10,-1
690,Ryan Smith (C/RW),University of Maine,28,6,3,9,0.32,21,-4
691,Alex Ierullo (LW),Bemidji State University,31,6,3,9,0.29,4,-1
692,Brady Schoo (D),Brown University,31,6,3,9,0.29,18,-1
693,Gavin Hain (C/LW),University of North Dakota,31,6,3,9,0.29,28,16
694,Phil Knies (LW/C),Miami University (Ohio),32,6,3,9,0.28,14,-5
695,Emil Westerlund (LW/RW),University of Maine,34,6,3,9,0.26,29,-6
696,Corey Andonovski (RW/LW),Princeton University,23,5,4,9,0.39,18,-7
697,Sam Knoblauch (RW),UMass-Lowell,27,5,4,9,0.33,12,-1
698,Jack Surowiec (C/LW),College of the Holy Cross,30,5,4,9,0.30,6,0
699,Joachim Weberg (LW),Brown University,34,5,4,9,0.26,2,-8
700,Matt Pulver (F),Air Force Academy,36,5,4,9,0.25,20,-4
701,Grant Loven (C),Northern Michigan University,37,5,4,9,0.24,14,6
702,Michael Lombardi (C/LW),Quinnipiac University,38,5,4,9,0.24,10,4
703,Jake Coleman (F),Robert Morris University,38,5,4,9,0.24,15,-6
704,Jake Massie (D),University of Vermont,30,4,5,9,0.30,34,-3
705,Matthew Thom (D),Princeton University,31,4,5,9,0.29,22,3
706,Conor O'Neil (LW),University of Vermont,31,4,5,9,0.29,31,4
707,Ted Hart (C/RW),Yale University,32,4,5,9,0.28,4,-5
708,Logan Drevitch (LW),Merrimack College,33,4,5,9,0.27,17,-9
709,Ryan Leibold (F),College of the Holy Cross,33,4,5,9,0.27,44,5
710,Lucas Condotta (C),UMass-Lowell,34,4,5,9,0.26,35,-1
711,Brennan Sanford (F),Michigan State University,36,4,5,9,0.25,42,-3
712,River Rymsha (D),Miami University (Ohio),36,4,5,9,0.25,50,-7
713,Lawton Courtnall (LW),Western Michigan University,37,4,5,9,0.24,18,-4
714,Ben Lown (C),Miami University (Ohio),38,4,5,9,0.24,2,-6
715,Nick Campoli (C),Clarkson University,39,4,5,9,0.23,8,4
716,Tipper Higgins (F),Army (U.S. Military Academy),39,4,5,9,0.23,12,-4
717,Taylor Maruya (F),Army (U.S. Military Academy),39,4,5,9,0.23,18,1
718,Raymond Brice (C/LW),Michigan Tech,28,3,6,9,0.32,4,1
719,Graham McPhee (C/W),Boston College,29,3,6,9,0.31,25,-7
720,Carmine Buono (D),University of Alaska-Anchorage,29,3,6,9,0.31,37,-2
721,Matt Alvaro (C/LW),University of Vermont,30,3,6,9,0.30,12,-10
722,Matt McLeod (C/RW),Canisius College,33,3,6,9,0.27,2,-8
723,Nils Rygaard (C/RW),University of Alaska-Anchorage,33,3,6,9,0.27,16,-9
724,Jack Gessert (LW),Brown University,34,3,6,9,0.26,16,7
725,Nick Boka (D),University of Michigan,36,3,6,9,0.25,40,-9
726,Rob Michel (D),University of Maine,36,3,6,9,0.25,55,12
727,Jade McMullen (RW),Western Michigan University,37,3,6,9,0.24,37,5
728,Darren Brady (D),RIT (Rochester Inst. of Tech.),38,3,6,9,0.24,14,8
729,Graham Slaggert (C/LW),University of Notre Dame,40,3,6,9,0.23,18,-1
730,Luke Orysiuk (D),Bentley University,23,2,7,9,0.39,16,8
731,Ruslan Rakhmatov (D),Sacred Heart University,25,2,7,9,0.36,65,3
732,Logan Coomes (LW),Merrimack College,30,2,7,9,0.30,6,-16
733,Andrew Gaus (RW),Yale University,30,2,7,9,0.30,10,7
734,Ace Cowans (C/LW),University of Vermont,33,2,7,9,0.27,13,-3
735,Michael Laidley (LW),St. Lawrence University,33,2,7,9,0.27,26,-24
736,Sasha Larocque (D),Ohio State University,33,2,7,9,0.27,39,11
737,Jon McDonald (D),UMass-Lowell,33,2,7,9,0.27,40,1
738,Alex Carle (D),Merrimack College,34,2,7,9,0.26,18,-11
739,Jacob Wilson (D),Arizona State University,34,2,7,9,0.26,47,5
740,Tyler Rockwell (D),Michigan Tech,35,2,7,9,0.26,6,6
741,Ted McGeen (LW),St. Lawrence University,35,2,7,9,0.26,12,-3
742,Anthony Baxter (D),UMass-Lowell,37,2,7,9,0.24,41,4
743,Sean Giles (D),Robert Morris University,38,2,7,9,0.24,45,-10
744,Evan Bell (D),Penn State University,21,1,8,9,0.43,6,8
745,Joey Matthews (D),Dartmouth College,34,1,8,9,0.26,16,6
746,Gordi Myer (D),Ohio State University,36,1,8,9,0.25,4,10
747,Ryan Polin (D),American International College,36,1,8,9,0.25,12,6
748,Ryan Black (D),Northern Michigan University,38,1,8,9,0.24,25,0
749,Riese Zmolek (D),Minnesota State University (Mankato),39,1,8,9,0.23,18,20
750,Jon Lizotte (D),St. Cloud State University,39,1,8,9,0.23,50,12
751,Colin Felix (D),UMass,41,1,8,9,0.22,28,2
752,Jesper Mattila (D),Boston College,39,0,9,9,0.23,6,-7
753,Grant Cooper (LW),Clarkson University,11,6,2,8,0.73,4,6
754,Mitchell Martan (LW),Canisius College,28,6,2,8,0.29,10,-4
755,Ryker Leer (LW),University of Alaska-Fairbanks,36,6,2,8,0.22,30,-17
756,Darius Davidson (F),American International College,30,5,3,8,0.27,0,-6
757,Michael Babcock (C/W),Merrimack College,32,5,3,8,0.25,39,-16
758,Alex Gilmour (LW),St. Lawrence University,36,5,3,8,0.22,14,-18
759,Bryan Basilico (LW),Lake Superior State University,37,5,3,8,0.22,12,0
760,Brandon Salerno (C),University of Alabama-Huntsville,38,5,3,8,0.21,12,-15
761,Austin Plevy (C),Northeastern University,39,5,3,8,0.21,11,0
762,Wes Baker (RW),Mercyhurst University,26,4,4,8,0.31,4,-3
763,Casey Linkenheld (LW),Bowling Green State University,32,4,4,8,0.25,18,0
764,Chris Miller (C),University of New Hampshire,34,4,4,8,0.24,14,-7
765,Biagio Lerario (C),Northeastern University,34,4,4,8,0.24,22,1
766,Todd Goehring (F),Sacred Heart University,35,4,4,8,0.23,2,1
767,Ryan Galt (F),University of Nebraska-Omaha,35,4,4,8,0.23,46,-13
768,Marc McLaughlin (C/RW),Boston College,39,4,4,8,0.21,20,-4
769,Jake Jackson (LW/C),Michigan Tech,22,3,5,8,0.36,4,-4
770,Chris Schutz (LW/RW),UMass-Lowell,25,3,5,8,0.32,0,5
771,Charlie Curti (D),Yale University,30,3,5,8,0.27,6,5
772,Phil Kemp (D),Yale University,30,3,5,8,0.27,35,-9
773,T.J. Friedmann (W/C),Quinnipiac University,31,3,5,8,0.26,9,3
774,Teemu Pulkkinen (RW),University of Nebraska-Omaha,31,3,5,8,0.26,27,-12
775,Desi Burgart (F),Quinnipiac University,33,3,5,8,0.24,8,2
776,Jarrod Gourley (D),Arizona State University,33,3,5,8,0.24,46,-3
777,Alex Truscott (F),Niagara University,35,3,5,8,0.23,22,-5
778,Ture Linden (C),RPI (Rensselaer Polytech. Inst.),36,3,5,8,0.22,8,-8
779,Kyle Betts (C),Cornell University,36,3,5,8,0.22,12,3
780,Colin O'Neill (F),UMass-Lowell,37,3,5,8,0.22,6,-5
781,Scott Davidson (F),Quinnipiac University,38,3,5,8,0.21,18,7
782,Mark Paolini (D),Princeton University,27,2,6,8,0.30,8,-4
783,Pierre-Luc Veillette (C),Lake Superior State University,32,2,6,8,0.25,10,2
784,Kevan Kilistoff (F),Dartmouth College,33,2,6,8,0.24,10,-6
785,Steenn Pasichnuk (RW),Arizona State University,33,2,6,8,0.24,33,2
786,Ryan Cloonan (LW),Boston University,34,2,6,8,0.24,35,-4
787,Jake McLaughlin (D),UMass,35,2,6,8,0.23,10,3
788,Dom Garcia (F),Arizona State University,35,2,6,8,0.23,30,-1
789,Jeremy Wu (D),Mercyhurst University,36,2,6,8,0.22,22,3
790,Kohen Olischefski (RW),University of Denver,39,2,6,8,0.21,8,0
791,Kristian Blumenschein (D),Colorado College,41,2,6,8,0.20,16,-4
792,Mike Gornall (F),RPI (Rensselaer Polytech. Inst.),21,1,7,8,0.38,4,-7
793,Zach Salloum (D),RIT (Rochester Inst. of Tech.),26,1,7,8,0.31,6,0
794,Tomi Hiekkavirta (D),University of Alaska-Anchorage,28,1,7,8,0.29,14,-11
795,Richard Boyd (D),University of New Hampshire,34,1,7,8,0.24,12,4
796,Jake Johnson (D),RPI (Rensselaer Polytech. Inst.),35,1,7,8,0.23,10,0
797,Ryan Zuhlsdorf (D),University of Minnesota,35,1,7,8,0.23,23,2
798,Sam Becker (D),University of Maine,36,1,7,8,0.22,8,3
799,Paul Meyer (D),Colgate University,36,1,7,8,0.22,14,-4
800,Will MacKinnon (D),University of New Hampshire,36,1,7,8,0.22,16,-1
801,Joe Rutkowski (D),Ferris State University,36,1,7,8,0.22,20,-18
802,Chris McKay (D),RIT (Rochester Inst. of Tech.),38,1,7,8,0.21,65,-6
803,Connor McDonald (D),Bowling Green State University,41,1,7,8,0.20,42,17
804,Sam Ruffin (F),University of Alaska-Fairbanks,29,0,8,8,0.28,31,-5
805,Brett Orr (D),Bentley University,31,0,8,8,0.26,2,10
806,Adam Tisdale (C),Clarkson University,33,0,8,8,0.24,2,10
807,Cam Clarke (D),Ferris State University,34,0,8,8,0.24,30,-7
808,Jared Kucharek (D),Western Michigan University,37,0,8,8,0.22,10,10
809,Alex Jaeckle (D),Canisius College,37,0,8,8,0.22,26,-6
810,Justin Misiak (C),Michigan Tech,37,6,1,7,0.19,14,-2
811,Tyler Drevitch (C),Merrimack College,32,5,2,7,0.22,35,-14
812,Aapeli Räsänen (C),Boston College,33,5,2,7,0.21,20,-2
813,Jared Pike (C),American International College,36,5,2,7,0.19,33,-11
814,Luke Stevens (LW),Yale University,23,4,3,7,0.30,19,-7
815,Jared Brandt (D),Niagara University,30,4,3,7,0.23,22,-9
816,Micah Miller (RW/C),St. Cloud State University,31,4,3,7,0.23,8,6
817,Marcel Godbout (C/RW),Sacred Heart University,31,4,3,7,0.23,10,-3
818,Kevin Obssuth (LW),Canisius College,32,4,3,7,0.22,4,-6
819,Jeffrey Stewart (LW),Colgate University,36,4,3,7,0.19,4,-11
820,Jacob Benson (C),St. Cloud State University,36,4,3,7,0.19,12,-3
821,Tyler Penner (RW/C),Colgate University,36,4,3,7,0.19,12,-8
822,Lee Lapid (C),Canisius College,12,3,4,7,0.58,21,-3
823,Thomas Beretta (C),Michigan Tech,20,3,4,7,0.35,10,-2
824,Joe Tyran (D),Air Force Academy,26,3,4,7,0.27,8,1
825,Liam MacDougall (C/W),Ferris State University,27,3,4,7,0.26,10,-8
826,Miles Gendron (D),University of Connecticut,30,3,4,7,0.23,26,0
827,Joe O'Connor (D),Quinnipiac University,31,3,4,7,0.23,30,11
828,Jack Donato (F),Harvard University,32,3,4,7,0.22,12,-1
829,Logan Gestro (D),Canisius College,33,3,4,7,0.21,16,-5
830,Michael Maloney (F),Brown University,34,3,4,7,0.21,4,-2
831,Shane McMahan (LW),Minnesota State University (Mankato),34,3,4,7,0.21,4,9
832,Jake Clifford (D),Arizona State University,34,3,4,7,0.21,33,7
833,Kaden Pickering (RW),St. Lawrence University,37,3,4,7,0.19,6,-22
834,Dylan Pitera (F),Bentley University,37,3,4,7,0.19,8,-3
835,Chris Grando (LW),Boston College,37,3,4,7,0.19,16,0
836,Connor Merkley (C),University of Alabama-Huntsville,37,3,4,7,0.19,22,-15
837,Michael Bevilacqua (D),Mercyhurst University,37,3,4,7,0.19,39,5
838,Jake Durflinger (RW/C),University of Denver,38,3,4,7,0.18,24,-3
839,Luke Voltin (D/C),Northern Michigan University,39,3,4,7,0.18,37,-5
840,Tyler Kirkup (C/LW),Bemidji State University,27,2,5,7,0.26,2,-3
841,Christian Evers (D),University of Vermont,29,2,5,7,0.24,14,-4
842,Juho Jokiharju (F),Clarkson University,30,2,5,7,0.23,8,6
843,Connor Brassard (D),Bentley University,30,2,5,7,0.23,33,-3
844,John Carter MacLean (C),Clarkson University,31,2,5,7,0.23,19,3
845,Collin Adams (LW/C),University of North Dakota,32,2,5,7,0.22,16,-7
846,Drayson Pears (D),University of Alaska-Anchorage,32,2,5,7,0.22,16,-19
847,Carter Turnbull (RW/C),University of Connecticut,32,2,5,7,0.22,29,-14
848,John DeRoche (D/F),University of Vermont,33,2,5,7,0.21,0,-4
849,Cole McCaskill (D),Colorado College,35,2,5,7,0.20,16,0
850,Tyler Jeanson (C),Colgate University,36,2,5,7,0.19,24,-14
851,Brody Valette (D),RIT (Rochester Inst. of Tech.),37,2,5,7,0.19,22,-7
852,Eric Butte (F),Army (U.S. Military Academy),38,2,5,7,0.18,6,-9
853,Adam Dawe (RW/C),University of Maine,17,1,6,7,0.41,12,-4
854,Brian Hurley (D),Clarkson University,24,1,6,7,0.29,8,5
855,Owen Norton (D),Mercyhurst University,32,1,6,7,0.22,6,-11
856,Cam Roth (D),Dartmouth College,33,1,6,7,0.21,16,-2
857,Anthony Wyse (D),University of New Hampshire,33,1,6,7,0.21,53,-9
858,Kurt Keats (F),UMass,34,1,6,7,0.21,8,7
859,Roman Kinal (D),University of Connecticut,34,1,6,7,0.21,22,-6
860,Tyler Inamoto (D),University of Wisconsin,34,1,6,7,0.21,71,-10
861,Ben Brinkman (D),University of Minnesota,38,1,6,7,0.18,16,11
862,Monte Graham (F),Miami University (Ohio),38,1,6,7,0.18,18,0
863,Caleb Schroer (F),Northern Michigan University,27,0,7,7,0.26,8,1
864,Zac Herrmann (D),Niagara University,31,0,7,7,0.23,2,-13
865,Michael Crocock (D),Sacred Heart University,37,0,7,7,0.19,12,3
866,Andrew Farny (D),Colorado College,41,0,7,7,0.17,15,-8
867,Zach Berzolla (D),Colorado College,41,0,7,7,0.17,28,0
868,Vincent De Mey (F),Northern Michigan University,29,5,1,6,0.21,4,-5
869,Troy Van Tetering (LW),University of Alaska-Fairbanks,33,5,1,6,0.18,6,-4
870,Brody Stevens (C),Michigan State University,33,5,1,6,0.18,22,-3
871,Andrew McIntyre (RW),St. Lawrence University,25,4,2,6,0.24,12,-4
872,Brendan Walkom (C/LW),Bentley University,28,4,2,6,0.21,10,3
873,Anthony Walsh (D/F),Yale University,28,4,2,6,0.21,33,-10
874,Riley Alferd (F),University of Nebraska-Omaha,34,4,2,6,0.18,22,-6
875,Bryan Lemos (RW/C),Providence College,17,3,3,6,0.35,0,3
876,Dominic Lutz (W),Ferris State University,25,3,3,6,0.24,2,-6
877,Chayse Primeau (W/C),University of Nebraska-Omaha,25,3,3,6,0.24,6,-10
878,Willie Brooks (D),Colgate University,27,3,3,6,0.22,6,-4
879,Adam Smith (D),Bowling Green State University,28,3,3,6,0.21,12,0
880,Nick Bowman (F),RPI (Rensselaer Polytech. Inst.),28,3,3,6,0.21,12,-6
881,Dixon Bowen (C/RW),University of North Dakota,32,3,3,6,0.19,60,0
882,Jacob Panetta (D),Colgate University,33,3,3,6,0.18,8,-15
883,Alex Bates (D),Sacred Heart University,33,3,3,6,0.18,10,8
884,Matthew Steeves (F),University of Notre Dame,34,3,3,6,0.18,10,0
885,Adam Goodsir (F),Michigan State University,34,3,3,6,0.18,20,-4
886,Tommy Apap (C/LW),Michigan State University,36,3,3,6,0.17,42,0
887,Adam Wilcox (RW),University of Alabama-Huntsville,37,3,3,6,0.16,6,-7
888,Billy Exell (RW),University of Minnesota-Duluth,42,3,3,6,0.14,14,5
889,Jake Harris (LW),Brown University,14,2,4,6,0.43,4,-3
890,Chris Van Os-Shaw (LW),Minnesota State University (Mankato),18,2,4,6,0.33,23,3
891,Nick Bruce (F),RIT (Rochester Inst. of Tech.),19,2,4,6,0.32,2,1
892,Hunter Racine (C/RW),Colgate University,22,2,4,6,0.27,4,-8
893,Elijiah Barriga (C),American International College,26,2,4,6,0.23,31,3
894,Connor Murphy (C),Cornell University,27,2,4,6,0.22,0,1
895,Brendan Smith (D),Cornell University,27,2,4,6,0.22,10,14
896,Liam Grande (RW),Princeton University,28,2,4,6,0.21,6,-9
897,Jackson Keane (C),University of North Dakota,28,2,4,6,0.21,8,7
898,Tanner Schachle (LW),University of Alaska-Anchorage,28,2,4,6,0.21,56,-8
899,Steve Hladin (LW),Sacred Heart University,33,2,4,6,0.18,6,-10
900,Anea Ferrario (D),Brown University,33,2,4,6,0.18,16,-1
901,Brendan Taylor (F),Union College,34,2,4,6,0.18,4,0
902,Zac Tierney (D),Ferris State University,34,2,4,6,0.18,14,-5
903,Casey Jerry (F),Canisius College,37,2,4,6,0.16,20,-7
904,Garrett Klee (F),Northern Michigan University,38,2,4,6,0.16,15,0
905,Michael Underwood (D),Clarkson University,38,2,4,6,0.16,18,5
906,Dan Billett (D),Bemidji State University,38,2,4,6,0.16,20,-2
907,Cody Haiskanen (D),Cornell University,20,1,5,6,0.30,8,4
908,Erich Jaeger (F),Air Force Academy,26,1,5,6,0.23,24,0
909,Eric Gotz (D),Michigan Tech,27,1,5,6,0.22,10,-6
910,Connor Moore (D),Boston College,29,1,5,6,0.21,12,-1
911,Benton Maass (D),University of New Hampshire,30,1,5,6,0.20,6,-9
912,Christian O'Neill (C),Princeton University,31,1,5,6,0.19,22,-9
913,Regan Seiferling (D),RIT (Rochester Inst. of Tech.),33,1,5,6,0.18,12,6
914,Antti Virtanen (D),University of Alaska-Fairbanks,34,1,5,6,0.18,42,-15
915,Max Willman (LW),Boston University,36,1,5,6,0.17,24,-10
916,James LaDouce (D),University of Alaska-Fairbanks,36,1,5,6,0.17,24,-9
917,Wyatt Aamodt (D),Minnesota State University (Mankato),36,1,5,6,0.17,29,-1
918,Patrick Giles (C/RW),Boston College,37,1,5,6,0.16,14,-2
919,Ryan Tait (RW/C),Providence College,41,1,5,6,0.15,8,2
920,Griffin Mendel (D),University of Denver,41,1,5,6,0.15,30,16
921,Luke Martin (D),University of Michigan,28,0,6,6,0.21,18,1
922,Trey deGraaf (F),University of Alaska-Anchorage,30,0,6,6,0.20,6,-12
923,Kale Bennett (D),Western Michigan University,34,0,6,6,0.18,8,0
924,Keith Muehlbauer (D),University of Maine,36,0,6,6,0.17,12,-1
925,James Vermeulen (D),Northern Michigan University,36,0,6,6,0.17,22,-1
926,Brendan Bushy (D),St. Cloud State University,38,0,6,6,0.16,6,4
927,John Teets (D),University of Alabama-Huntsville,38,0,6,6,0.16,16,-22
928,Matt Anderson (D),University of Minnesota-Duluth,42,0,6,6,0.14,14,3
929,Jasen Fernsler (C),Ferris State University,19,4,1,5,0.26,6,-4
930,Dan Winslow (F),Quinnipiac University,20,4,1,5,0.25,4,5
931,Adam Winborg (C),University of Michigan,27,4,1,5,0.19,8,-4
932,Cam Burke (C),University of Notre Dame,32,4,1,5,0.16,23,-3
933,Jake Marrello (F),RPI (Rensselaer Polytech. Inst.),34,4,1,5,0.15,20,-7
934,Michael Wilson (F),Army (U.S. Military Academy),16,3,2,5,0.31,21,-7
935,Jonathan Lazarus (RW),Mercyhurst University,17,3,2,5,0.29,5,-2
936,Jordan Peacock (F),RIT (Rochester Inst. of Tech.),18,3,2,5,0.28,4,5
937,Ryan Blankemeier (C),Dartmouth College,21,3,2,5,0.24,2,-1
938,Kevin Charyszyn (F),Clarkson University,23,3,2,5,0.22,6,3
939,Andrew Petrucci (C),RIT (Rochester Inst. of Tech.),28,3,2,5,0.18,6,-4
940,Jacob Hetz (LW),Ferris State University,28,3,2,5,0.18,16,-6
941,Matt Lombardozzi (D),Bentley University,29,3,2,5,0.17,20,6
942,Luke Keenan (C),Princeton University,30,3,2,5,0.17,2,-2
943,Charlie Barrow (D),College of the Holy Cross,30,3,2,5,0.17,4,-16
944,Ryan Norman (LW),University of Minnesota,31,3,2,5,0.16,6,-8
945,Luke Shiplo (D),Quinnipiac University,31,3,2,5,0.16,37,9
946,Ryan Kruper (F),RIT (Rochester Inst. of Tech.),32,3,2,5,0.16,24,-1
947,Austin Pooley (C),Ohio State University,33,3,2,5,0.15,4,-1
948,Josh Kosack (RW),Union College,33,3,2,5,0.15,14,-6
949,Dante Palecco (LW),Yale University,33,3,2,5,0.15,18,-1
950,Jasper Weatherby (C/LW),University of North Dakota,36,3,2,5,0.14,22,-5
951,Bradley Johnson (D),Bemidji State University,38,3,2,5,0.13,12,-7
952,Travis Kothenbeutel (F),University of Nebraska-Omaha,22,2,3,5,0.23,2,-4
953,Trey Dodd (F),Brown University,24,2,3,5,0.21,2,1
954,Ryan Cox (F),Niagara University,25,2,3,5,0.20,4,1
955,Jay O'Brien (C),Providence College,25,2,3,5,0.20,10,1
956,Ethan Johnson (F),Mercyhurst University,26,2,3,5,0.19,8,-6
957,Jonah Renouf (LW),University of Alaska-Anchorage,27,2,3,5,0.19,18,-10
958,Melvin Karlsson (RW/LW),Lake Superior State University,28,2,3,5,0.18,2,-5
959,Jarrett Lee (F),Northern Michigan University,28,2,3,5,0.18,16,-1
960,Peter Kessel (F),College of the Holy Cross,29,2,3,5,0.17,6,-1
961,Cam Strong (LW),Dartmouth College,30,2,3,5,0.17,6,-6
962,Jacob Dalton (D),Bowling Green State University,31,2,3,5,0.16,6,8
963,Justin Young (C),University of Alaska-Fairbanks,33,2,3,5,0.15,14,-3
964,Marshal Plunkett (D),Army (U.S. Military Academy),33,2,3,5,0.15,18,-11
965,Pierce Crawford (F),University of Notre Dame,34,2,3,5,0.15,2,-3
966,Eric Esposito (LW),University of New Hampshire,36,2,3,5,0.14,14,-5
967,Dan Bailey (D),Air Force Academy,36,2,3,5,0.14,28,-7
968,Lucas Jaycox (D),St. Cloud State University,39,2,3,5,0.13,4,8
969,Tyler Hayes (D),Niagara University,14,1,4,5,0.36,2,5
970,Justin Michaelian (F),Ferris State University,17,1,4,5,0.29,6,3
971,Jakub Sirota (D),University of Maine,18,1,4,5,0.28,4,0
972,Kip Hoffmann (F),Robert Morris University,20,1,4,5,0.25,2,-7
973,Nick Marin (F),UMass-Lowell,20,1,4,5,0.25,4,8
974,Miguel Fidler (LW),Ohio State University,22,1,4,5,0.23,4,0
975,Carter Long (D),University of Vermont,24,1,4,5,0.21,8,-7
976,Cole Krygier (D),Michigan State University,26,1,4,5,0.19,16,-5
977,Eric MacAdams (RW),University of New Hampshire,26,1,4,5,0.19,22,-5
978,Jake Wahlin (LW),St. Cloud State University,27,1,4,5,0.19,8,-6
979,Matthew Kellenberger (D),Princeton University,27,1,4,5,0.19,10,-15
980,Shane Kuzmeski (D),Clarkson University,27,1,4,5,0.19,21,7
981,Drake Glover (C),University of Alaska-Anchorage,29,1,4,5,0.17,12,-2
982,Kevin Dineen (F),Army (U.S. Military Academy),29,1,4,5,0.17,12,-3
983,Andy Carroll (D),Minnesota State University (Mankato),29,1,4,5,0.17,25,13
984,Jack DeBoer (C),Boston University,30,1,4,5,0.17,4,-1
985,Joe Leahy (D),Cornell University,30,1,4,5,0.17,18,3
986,Billy Sweezey (D),Yale University,32,1,4,5,0.16,26,2
987,Dominic Dockery (D),Merrimack College,33,1,4,5,0.15,18,-27
988,Benjamin Sharf (C),Colgate University,34,1,4,5,0.15,10,-14
989,Matt Slick (D),College of the Holy Cross,34,1,4,5,0.15,12,3
990,Ryan Cook (D),Merrimack College,34,1,4,5,0.15,53,-14
991,David Baskerville (C),Canisius College,35,1,4,5,0.14,4,-3
992,Nate Knoepke (D),University of Nebraska-Omaha,35,1,4,5,0.14,20,-11
993,T.J. Samec (D),RPI (Rensselaer Polytech. Inst.),35,1,4,5,0.14,29,-2
994,Brendan Riley (C),Mercyhurst University,35,1,4,5,0.14,31,-11
995,Jack Zielinski (D),Niagara University,37,1,4,5,0.14,12,7
996,John Zimmerman (D),Army (U.S. Military Academy),17,0,5,5,0.29,30,-2
997,Harrison Markell (D),Dartmouth College,31,0,5,5,0.16,10,-10
998,John Schuldt (D),University of Nebraska-Omaha,31,0,5,5,0.16,12,-7
999,Thomas Grant (D),RPI (Rensselaer Polytech. Inst.),36,0,5,5,0.14,20,-14
1000,Rourke Russell (D),Miami University (Ohio),37,0,5,5,0.14,24,-8
1001,Davis Bunz (D),Providence College,42,0,5,5,0.12,12,5
1002,Wojciech Stachowiak (LW/RW),Michigan State University,27,4,0,4,0.15,4,-10
1003,Tyler Vold (D),Bemidji State University,30,4,0,4,0.13,2,-4
1004,Frank Boie (D),College of the Holy Cross,6,3,1,4,0.67,2,3
1005,Marshall Moise (F),Ferris State University,9,3,1,4,0.44,9,1
1006,Koby Bender (RW/C),University of Minnesota-Duluth,16,3,1,4,0.25,0,2
1007,Mitchel Slattery (RW),Northern Michigan University,33,3,1,4,0.12,18,-5
1008,Eric Sinclair (D),University of Alaska-Anchorage,33,3,1,4,0.12,37,-14
1009,Jack Ramsey (D/RW),University of Minnesota,38,3,1,4,0.11,6,-3
1010,Justin Fregona (RW),University of New Hampshire,11,2,2,4,0.36,8,4
1011,Andrew Bellant (F),Michigan Tech,13,2,2,4,0.31,27,-3
1012,Adam Pilewicz (D),Penn State University,14,2,2,4,0.29,0,5
1013,Lucas Breault (C),Union College,19,2,2,4,0.21,14,-6
1014,Michael Joyaux (D),Western Michigan University,20,2,2,4,0.20,4,-6
1015,Alec Mehr (C),Brown University,22,2,2,4,0.18,8,-3
1016,Zachary de Concilys (RW),Sacred Heart University,23,2,2,4,0.17,8,-1
1017,Donovan Ott (RW),RPI (Rensselaer Polytech. Inst.),24,2,2,4,0.17,6,-6
1018,Michael Ryan (D),Union College,29,2,2,4,0.14,10,2
1019,Steven Spinner (RW),University of Nebraska-Omaha,29,2,2,4,0.14,18,-16
1020,Marshall Bowery (F),Air Force Academy,30,2,2,4,0.13,8,-3
1021,Meirs Moore (D),RPI (Rensselaer Polytech. Inst.),30,2,2,4,0.13,12,-11
1022,Zach Metsa (D),Quinnipiac University,32,2,2,4,0.13,4,2
1023,Bryce Misley (C),University of Vermont,32,2,2,4,0.13,12,-7
1024,Matt Cairns (D),Cornell University,32,2,2,4,0.13,20,-2
1025,Trevor Recktenwald (F),Ferris State University,32,2,2,4,0.13,26,-11
1026,Nick Jenny (D),Robert Morris University,33,2,2,4,0.12,21,-18
1027,Brendan Demler (D),Dartmouth College,34,2,2,4,0.12,21,1
1028,Kyle Horsman (LW/D),Robert Morris University,35,2,2,4,0.11,8,3
1029,Jack Quinlivan (F),University of Maine,36,2,2,4,0.11,6,-7
1030,Brady Ferner (D),RPI (Rensselaer Polytech. Inst.),36,2,2,4,0.11,10,-7
1031,Tommy Miller (D),Michigan State University,36,2,2,4,0.11,18,-14
1032,Benjamin Israel (D),Colorado College,38,2,2,4,0.11,18,-3
1033,Michael Coyne (F),Robert Morris University,39,2,2,4,0.10,34,-12
1034,Ryker Killins (D),Ferris State University,19,1,3,4,0.21,10,-4
1035,Colin Bernard (D),Sacred Heart University,19,1,3,4,0.21,12,1
1036,Alex Green (D),Cornell University,20,1,3,4,0.20,8,-6
1037,Jordan Xavier (C/RW),University of Alaska-Anchorage,21,1,3,4,0.19,0,-11
1038,Matt Koopman (C/LW),Providence College,22,1,3,4,0.18,2,-1
1039,Grant Gabriele (D),Ohio State University,24,1,3,4,0.17,0,3
1040,Nicolas Mucci (F),Niagara University,24,1,3,4,0.17,12,-1
1041,Sam McCormick (RW),Ohio State University,25,1,3,4,0.16,2,5
1042,Joe Sofo (F),University of Alaska-Anchorage,26,1,3,4,0.15,10,-15
1043,Jeff Baum (D),American International College,26,1,3,4,0.15,14,-12
1044,David Parrottino (F),Canisius College,26,1,3,4,0.15,19,-9
1045,Carson Dimoff (LW),St. Lawrence University,27,1,3,4,0.15,18,-12
1046,Andrew Dodson (RW),University of Alabama-Huntsville,27,1,3,4,0.15,38,-9
1047,George Mika (F),UMass,28,1,3,4,0.14,6,3
1048,Tyler Heidt (D),Merrimack College,28,1,3,4,0.14,14,-5
1049,Daniel Warpecha (LW),Dartmouth College,29,1,3,4,0.14,4,-8
1050,Zachary Emelifeonwu (LW),Union College,29,1,3,4,0.14,34,-7
1051,Jack Suter (C/RW),UMass,30,1,3,4,0.13,2,4
1052,Jay Mackie (C),College of the Holy Cross,31,1,3,4,0.13,8,-7
1053,Adam Roeder (D),Northern Michigan University,32,1,3,4,0.13,2,-6
1054,Corey Renwick (F),University of Alaska-Anchorage,34,1,3,4,0.12,17,-8
1055,Griffin Luce (D),University of Michigan,35,1,3,4,0.11,39,3
1056,Griffin Lunn (F),Colgate University,36,1,3,4,0.11,22,-10
1057,Ian Mansfield (F),Army (U.S. Military Academy),37,1,3,4,0.11,10,-14
1058,Tanner Ockey (C),Colorado College,38,1,3,4,0.11,39,-3
1059,Spencer Stastney (D),University of Notre Dame,39,1,3,4,0.10,8,1
1060,Taylor Brierley (D),Union College,39,1,3,4,0.10,16,4
1061,Jackson Barliant (C),Sacred Heart University,13,0,4,4,0.31,6,1
1062,Ben Taylor (RW),Brown University,17,0,4,4,0.24,2,2
1063,Will Schlagenhauf (F),Bentley University,20,0,4,4,0.20,2,-3
1064,John Laurito (F),Army (U.S. Military Academy),20,0,4,4,0.20,25,-7
1065,Ethan Roswell (D),Bentley University,22,0,4,4,0.18,4,12
1066,Jakob Stridsberg (D),Arizona State University,26,0,4,4,0.15,14,7
1067,Colin Doyle (C),University of Alaska-Fairbanks,26,0,4,4,0.15,54,-6
1068,Corson Green (D),University of Connecticut,27,0,4,4,0.15,16,-1
1069,Zach Yoder (D),Ferris State University,27,0,4,4,0.15,26,-10
1070,Jonny Tychonick (D),University of North Dakota,28,0,4,4,0.14,14,-1
1071,Sam Rossini (D),University of Minnesota,28,0,4,4,0.14,36,-3
1072,Jordan Wishman (D),Niagara University,31,0,4,4,0.13,12,1
1073,Will Brophy (D),College of the Holy Cross,31,0,4,4,0.13,22,1
1074,Julian Kislin (D),Northeastern University,32,0,4,4,0.13,16,5
1075,Charlie Marchand (D),Bentley University,33,0,4,4,0.12,8,3
1076,Avni Berisha (D),UMass-Lowell,34,0,4,4,0.12,8,5
1077,Max Luukko (D),Sacred Heart University,34,0,4,4,0.12,10,-2
1078,Philip Nyberg (D),University of Connecticut,34,0,4,4,0.12,20,0
1079,Adam Karashik (D),University of Connecticut,34,0,4,4,0.12,22,0
1080,John McDermott (LW),Providence College,37,0,4,4,0.11,6,1
1081,Wyllum Deveaux (F),Harvard University,26,3,0,3,0.12,26,-4
1082,Rhett Kingston (LW),Western Michigan University,13,2,1,3,0.23,6,3
1083,Logan Milliken (D),College of the Holy Cross,17,2,1,3,0.18,2,-4
1084,Laine McKay (C/RW),Merrimack College,17,2,1,3,0.18,4,-12
1085,Carter Johnson (C),Miami University (Ohio),19,2,1,3,0.16,8,2
1086,Zach Lavalle (C),Miami University (Ohio),22,2,1,3,0.14,2,-2
1087,Austin Kamer (RW),Michigan State University,22,2,1,3,0.14,4,-4
1088,R.J. Murphy (C),Harvard University,23,2,1,3,0.13,6,1
1089,Andrew Peski (D),University of North Dakota,27,2,1,3,0.11,2,2
1090,Connor Wood (RW),University of Alabama-Huntsville,27,2,1,3,0.11,29,-2
1091,Casey Johnson (D),University of North Dakota,31,2,1,3,0.10,15,0
1092,J.D. Pogue (LW),Canisius College,33,2,1,3,0.09,14,-5
1093,Dylan Woolf (D),St. Lawrence University,33,2,1,3,0.09,84,-17
1094,Joel Janatuinen (LW),University of North Dakota,14,1,2,3,0.21,8,-2
1095,Brennan Blaszczak (F),University of Alaska-Fairbanks,16,1,2,3,0.19,0,-2
1096,Zach Mills (LW),Niagara University,16,1,2,3,0.19,2,-5
1097,Patrick O'Leary (D),College of the Holy Cross,16,1,2,3,0.19,6,0
1098,Garrett Wait (LW),University of Minnesota,19,1,2,3,0.16,6,-4
1099,Martin Fréchette (RW),University of Vermont,21,1,2,3,0.14,6,-6
1100,Pierce Pluemer (LW),Air Force Academy,23,1,2,3,0.13,10,-4
1101,Geoff Lawson (D),Robert Morris University,23,1,2,3,0.13,32,-3
1102,Frankie Cefalu (C),University of New Hampshire,24,1,2,3,0.13,2,1
1103,Jake Joffe (RW),RIT (Rochester Inst. of Tech.),24,1,2,3,0.13,2,-2
1104,Bobby Hampton (C),Northeastern University,24,1,2,3,0.13,4,2
1105,Ivan Chukarov (D),UMass,25,1,2,3,0.12,16,4
1106,Graham Lillibridge (D),Yale University,26,1,2,3,0.12,8,-8
1107,Conner Jean (C),College of the Holy Cross,27,1,2,3,0.11,8,0
1108,Lukas Buchta (D),University of Nebraska-Omaha,27,1,2,3,0.11,14,-16
1109,Clayton Han (D),Dartmouth College,28,1,2,3,0.11,4,-1
1110,Mike Soucier (C/LW),Bemidji State University,29,1,2,3,0.10,17,-3
1111,Chase Gamelin (F),Lake Superior State University,32,1,2,3,0.09,0,0
1112,Owen Grant (D),University of Vermont,32,1,2,3,0.09,6,2
1113,Daniel Perez (F),University of Maine,33,1,2,3,0.09,23,-6
1114,Kenny Citron (D),Colgate University,34,1,2,3,0.09,31,-17
1115,Connor Frantti (D),Northern Michigan University,34,1,2,3,0.09,41,-10
1116,Joe Sacco (RW),University of New Hampshire,35,1,2,3,0.09,2,-5
1117,Gvido Jansons (D),Arizona State University,35,1,2,3,0.09,16,5
1118,Brendan Warren (LW/C),University of Michigan,36,1,2,3,0.08,21,-9
1119,Erich Fear (D),University of Denver,38,1,2,3,0.08,32,2
1120,Cameron Orchard (C),Western Michigan University,5,0,3,3,0.60,0,4
1121,Zach Noble (F),Michigan Tech,10,0,3,3,0.30,4,3
1122,Jason Dhooghe (F),University of Wisconsin,20,0,3,3,0.15,6,-7
1123,Canon Pieper (F),University of Maine,20,0,3,3,0.15,10,-5
1124,Robbie Stucker (D),University of Minnesota,21,0,3,3,0.14,6,2
1125,James Gobetz (D),Penn State University,23,0,3,3,0.13,8,-2
1126,Bryce Dolan (D),College of the Holy Cross,25,0,3,3,0.12,8,-3
1127,Zach Court (LW),University of Alaska-Anchorage,25,0,3,3,0.12,10,-9
1128,Derian Hamilton (D),Penn State University,26,0,3,3,0.12,6,10
1129,Carter Ekberg (D),Air Force Academy,27,0,3,3,0.11,8,-1
1130,Andrew Quetell (D),Army (U.S. Military Academy),28,0,3,3,0.11,6,-8
1131,Mark Cheremeta (LW),Boston University,29,0,3,3,0.10,8,-5
1132,Tyler Anderson (D),Lake Superior State University,29,0,3,3,0.10,22,-3
1133,Cory Thomas (D),University of Vermont,30,0,3,3,0.10,20,-2
1134,Cameron White (D),St. Lawrence University,30,0,3,3,0.10,22,-9
1135,Blake Gober (F),Penn State University,30,0,3,3,0.10,31,-4
1136,Jacob Olson (D),Harvard University,32,0,3,3,0.09,10,1
1137,Nate Clurman (D),University of Notre Dame,39,0,3,3,0.08,8,3
1138,Brian Williams (C),Colorado College,5,2,0,2,0.40,0,1
1139,Bobby Kaiser (RW),UMass,7,2,0,2,0.29,4,2
1140,Eddie Pavlini (F),St. Lawrence University,14,2,0,2,0.14,14,-1
1141,Cam Amantea (F),University of Alaska-Anchorage,14,2,0,2,0.14,40,-3
1142,Cody DePourcq (F),Bentley University,15,2,0,2,0.13,0,2
1143,Jack Doremus (C/W),University of Denver,19,2,0,2,0.11,8,-1
1144,Erkka Vänskä (F),College of the Holy Cross,22,2,0,2,0.09,2,2
1145,Yuki Miura (C/RW),Lake Superior State University,23,2,0,2,0.09,17,-3
1146,Tucker DeYoung (F),Army (U.S. Military Academy),25,2,0,2,0.08,2,0
1147,Matt Serratore (F),Air Force Academy,3,1,1,2,0.67,4,-4
1148,Stephen Kleysen (D),Niagara University,6,1,1,2,0.33,4,0
1149,Jared Cockrell (F),Colgate University,7,1,1,2,0.29,0,1
1150,Matthew Dawson (D),University of New Hampshire,8,1,1,2,0.25,2,0
1151,Max Sauvé (F),Penn State University,9,1,1,2,0.22,0,-3
1152,Nolan Aibel (F),Brown University,9,1,1,2,0.22,4,-1
1153,Andrew Best (F),Bentley University,10,1,1,2,0.20,2,3
1154,Dallas Comeau (W/C),University of Vermont,14,1,1,2,0.14,6,1
1155,Christian Simeone (F),Merrimack College,15,1,1,2,0.13,2,-4
1156,Kyle Mayhew (D),University of Denver,17,1,1,2,0.12,6,2
1157,Alec Semandel (D),Lake Superior State University,17,1,1,2,0.12,12,-4
1158,Matt Foley (D),Yale University,18,1,1,2,0.11,2,2
1159,Shane Bear (D),RPI (Rensselaer Polytech. Inst.),18,1,1,2,0.11,4,-9
1160,Alex Adams (F),Bemidji State University,19,1,1,2,0.11,2,-6
1161,Chase Ellingson (C/RW),University of Alaska-Fairbanks,19,1,1,2,0.11,6,-7
1162,Spencer Kryczka (C),Princeton University,20,1,1,2,0.10,8,-4
1163,Jesse Jacques (F),University of Minnesota-Duluth,21,1,1,2,0.10,6,1
1164,Kohei Sato (LW),University of New Hampshire,21,1,1,2,0.10,10,-3
1165,Nick Leivermann (D),University of Notre Dame,23,1,1,2,0.09,0,-1
1166,Zac Robbins (F),University of Connecticut,23,1,1,2,0.09,6,-10
1167,Andrew Lane (D),University of Alaska-Anchorage,23,1,1,2,0.09,12,-9
1168,Aaron McPheters (D),University of Alaska-Anchorage,23,1,1,2,0.09,22,-9
1169,Cole McBride (C),Merrimack College,24,1,1,2,0.08,14,-7
1170,Brett Jewell (RW),Yale University,24,1,1,2,0.08,16,0
1171,Ron Greco (F),Boston College,25,1,1,2,0.08,0,-6
1172,A.J. Villella (D),Northeastern University,25,1,1,2,0.08,6,-1
1173,Austin Goldstein (F),Northeastern University,25,1,1,2,0.08,6,0
1174,Jalen Schulz (D),University of Nebraska-Omaha,25,1,1,2,0.08,25,-6
1175,Christian Mohs (F),Miami University (Ohio),26,1,1,2,0.08,4,2
1176,Darian Romanko (C),University of Minnesota,27,1,1,2,0.07,10,-5
1177,Jonny Hill (D),Niagara University,28,1,1,2,0.07,16,-7
1178,Jason Smallidge (D),University of Nebraska-Omaha,28,1,1,2,0.07,46,-8
1179,Zach Yon (LW),University of North Dakota,29,1,1,2,0.07,6,-3
1180,Todd Kiilunen (D),Michigan Tech,29,1,1,2,0.07,20,-3
1181,Paul McAvoy (F),Colgate University,31,1,1,2,0.06,8,-6
1182,Ryan O'Connell (D),Ohio State University,31,1,1,2,0.06,10,2
1183,Matt Long (F),Canisius College,31,1,1,2,0.06,14,-9
1184,Tommy Parran (D),Ohio State University,34,1,1,2,0.06,29,4
1185,Liam Motley (F),Cornell University,35,1,1,2,0.06,10,-3
1186,Matt Quercia (C/LW),Boston University,36,1,1,2,0.06,28,-3
1187,Geoff Kitt (C),Mercyhurst University,37,1,1,2,0.05,12,-15
1188,Gabriel Chabot (RW/D),Boston University,38,1,1,2,0.05,6,-7
1189,Bailey Newton (D),University of Alabama-Huntsville,38,1,1,2,0.05,93,-18
1190,Jacob Tortora (LW),Boston College,4,0,2,2,0.50,4,0
1191,Jake Bunz (D),University of Wisconsin,5,0,2,2,0.40,0,-1
1192,Noah Jordan (RW),Miami University (Ohio),6,0,2,2,0.33,6,1
1193,Jake Wise (C/LW),Boston University,12,0,2,2,0.17,0,-7
1194,Ethan Stewart (F),Ferris State University,12,0,2,2,0.17,4,-7
1195,Max Harper (F),Air Force Academy,14,0,2,2,0.14,0,-3
1196,Matt Denman (D),University of Minnesota,14,0,2,2,0.14,0,1
1197,Coby Mack (D),Army (U.S. Military Academy),14,0,2,2,0.14,6,-4
1198,Matt Meier (F),Bowling Green State University,14,0,2,2,0.14,8,-2
1199,Max Balinson (D),Arizona State University,15,0,2,2,0.13,2,-2
1200,Mathew Harris (D),RPI (Rensselaer Polytech. Inst.),16,0,2,2,0.13,2,-4
1201,Croix Evingson (D),UMass-Lowell,16,0,2,2,0.13,4,-5
1202,Spencer Berry (D),RIT (Rochester Inst. of Tech.),17,0,2,2,0.12,4,1
1203,Devon Daniels (D),Mercyhurst University,17,0,2,2,0.12,10,-2
1204,Michael Schumacher (D),St. Lawrence University,18,0,2,2,0.11,2,-5
1205,Darby Gula (D),Bemidji State University,18,0,2,2,0.11,2,2
1206,Jamie Rome (F),Western Michigan University,19,0,2,2,0.11,35,5
1207,Zach Walker (RW),Boston College,22,0,2,2,0.09,2,-2
1208,Corey Moriarty (D),University of Vermont,23,0,2,2,0.09,4,-4
1209,Nolan Sawchuk (D),UMass-Lowell,23,0,2,2,0.09,12,2
1210,Alex Pernitsky (D),Colorado College,24,0,2,2,0.08,2,1
1211,Jarod Zirbel (F),University of Wisconsin,27,0,2,2,0.07,2,-5
1212,Justin Wells (D),Bowling Green State University,27,0,2,2,0.07,4,4
1213,Shawn Knowlton (F),Air Force Academy,28,0,2,2,0.07,8,-9
1214,Brendon Michaelian (D),Robert Morris University,28,0,2,2,0.07,25,-9
1215,Jeremy Germain (C/LW),Princeton University,29,0,2,2,0.07,4,-5
1216,Reid Yochim (D),Princeton University,31,0,2,2,0.06,12,1
1217,Dayne Finnson (D),University of Alabama-Huntsville,32,0,2,2,0.06,33,-7
1218,Christian Krygier (D),Michigan State University,33,0,2,2,0.06,24,-11
1219,Malcolm Hayes (D),University of Alaska-Anchorage,34,0,2,2,0.06,16,-15
1220,Robby Fosdick (D),Northern Michigan University,34,0,2,2,0.06,22,-8
1221,Brandon Watt (C),Robert Morris University,35,0,2,2,0.06,12,-7
1222,Luke McInnis (D),Boston College,35,0,2,2,0.06,30,-11
1223,Bray Crowder (D),Miami University (Ohio),36,0,2,2,0.06,24,-5
1224,Simon Butala (D),University of Maine,36,0,2,2,0.06,45,-12
1225,Hugo Blixt (D),Boston University,37,0,2,2,0.05,12,-2
1226,Nolan Schaeffer (D),Robert Morris University,37,0,2,2,0.05,31,-10
1227,Drew Lennon (D),University of Alabama-Huntsville,38,0,2,2,0.05,12,-14
1228,Michael Karow (D),Boston College,39,0,2,2,0.05,18,-3
1229,Ty Pochipinski (F),Colorado College,4,1,0,1,0.25,2,2
1230,Matus Spodniak (C/LW),American International College,5,1,0,1,0.20,0,3
1231,Brandon Schultz (C/LW),Northeastern University,6,1,0,1,0.17,2,0
1232,Alec Vanko (D),Minnesota State University (Mankato),6,1,0,1,0.17,4,0
1233,Jack Olmstead (C/LW/RW),University of Michigan,7,1,0,1,0.14,4,1
1234,Ben Allen (LW),University of Alabama-Huntsville,9,1,0,1,0.11,0,-3
1235,Joe Cipollone (C),University of New Hampshire,11,1,0,1,0.09,0,1
1236,Jake Gresh (D),University of Alaska-Fairbanks,11,1,0,1,0.09,2,1
1237,Chase Olsen (F),Merrimack College,12,1,0,1,0.08,0,1
1238,Tyr Thompson (C),University of Alabama-Huntsville,12,1,0,1,0.08,6,-4
1239,Jake Nielsen (F),St. Lawrence University,12,1,0,1,0.08,8,0
1240,David Keefer (RW),Michigan State University,14,1,0,1,0.07,2,-5
1241,August von Ungern-Sternberg Kuzara (F),Merrimack College,15,1,0,1,0.07,2,-6
1242,Jere Astrén (D),Clarkson University,16,1,0,1,0.06,8,5
1243,Yevgen Fadyeyev (F),Ohio State University,17,1,0,1,0.06,15,0
1244,Jared Nash (C),University of Alaska-Anchorage,18,1,0,1,0.06,6,-11
1245,Andrew Petrillo (D),University of Vermont,18,1,0,1,0.06,6,-1
1246,Jordan Fogarty (F),Princeton University,19,1,0,1,0.05,0,-4
1247,Evan Tschumi (C/W),Colgate University,19,1,0,1,0.05,23,-2
1248,Jan Stefka (F),American International College,20,1,0,1,0.05,6,2
1249,Joey Fallon (F),Princeton University,21,1,0,1,0.05,8,-3
1250,Alex Ambrosio (F),Lake Superior State University,22,1,0,1,0.05,12,0
1251,Aidan Girduckis (D),Robert Morris University,22,1,0,1,0.05,12,-1
1252,Zac Masson (RW),University of Alaska-Anchorage,22,1,0,1,0.05,16,-8
1253,Brendan Less (D),Dartmouth College,22,1,0,1,0.05,20,-3
1254,Bryson Traptow (F),RIT (Rochester Inst. of Tech.),23,1,0,1,0.04,14,-3
1255,Jackson Bales (C),Merrimack College,24,1,0,1,0.04,4,-7
1256,Cooper Watson (D),Michigan Tech,25,1,0,1,0.04,16,-5
1257,David Trinkberger (D),University of Alaska-Anchorage,26,1,0,1,0.04,26,-8
1258,Mark Logan (LW),RIT (Rochester Inst. of Tech.),28,1,0,1,0.04,37,0
1259,Marc Gatcomb (C/RW),University of Connecticut,31,1,0,1,0.03,4,-10
1260,Matt McArdle (D),Merrimack College,33,1,0,1,0.03,22,-14
1261,Shane Kavanagh (F),Providence College,35,1,0,1,0.03,14,2
1262,Christian Lloyd (D),Sacred Heart University,2,0,1,1,0.50,0,2
1263,David Giunta (D),Bentley University,2,0,1,1,0.50,0,0
1264,Colin Tonge (LW),Princeton University,2,0,1,1,0.50,0,1
1265,Blake Hayward (LW),Union College,3,0,1,1,0.33,4,2
1266,Cale List (D),UMass-Lowell,4,0,1,1,0.25,0,3
1267,Cameron Spicer (D),University of Maine,4,0,1,1,0.25,0,-1
1268,Zak Galambos (D),Minnesota State University (Mankato),4,0,1,1,0.25,0,0
1269,Sam Hesler (F),Dartmouth College,4,0,1,1,0.25,2,-2
1270,Sam Kauppila (F),Bentley University,5,0,1,1,0.20,0,-1
1271,Mel Melconian (C),Sacred Heart University,6,0,1,1,0.17,0,1
1272,Mark Dufour (RW),Union College,7,0,1,1,0.14,0,0
1273,Shane Bednard (C),Bowling Green State University,7,0,1,1,0.14,2,1
1274,Paul Cotter (C/W),Western Michigan University,8,0,1,1,0.13,2,-5
1275,Will Conley (F),College of the Holy Cross,9,0,1,1,0.11,0,-3
1276,Will D'Orsi (C),Yale University,9,0,1,1,0.11,0,0
1277,Jarod Hilderman (D),University of Minnesota-Duluth,9,0,1,1,0.11,2,-6
1278,Kyle Johnson (F),Yale University,10,0,1,1,0.10,0,1
1279,Oskar Strömberg (D),American International College,11,0,1,1,0.09,0,-1
1280,Owen Guy (C),Lake Superior State University,12,0,1,1,0.08,0,-7
1281,Jake Smith (F),Michigan State University,12,0,1,1,0.08,0,-1
1282,Joseph Maguire (D),Brown University,12,0,1,1,0.08,2,-4
1283,Matthew Doran (D),University of Alaska-Fairbanks,12,0,1,1,0.08,4,-2
1284,Simon Lööf (D),Merrimack College,12,0,1,1,0.08,6,-3
1285,Jordan Muzzillo (D),University of Alaska-Fairbanks,13,0,1,1,0.08,2,-5
1286,Jared Resseguie (F),University of Denver,13,0,1,1,0.08,5,-1
1287,Carson Musser (D),Bowling Green State University,13,0,1,1,0.08,6,3
1288,Connor Brown-Maloski (F),Bemidji State University,14,0,1,1,0.07,4,-2
1289,Sami Pharaon (D),Princeton University,15,0,1,1,0.07,4,-7
1290,Cole Pickup (F),University of Nebraska-Omaha,16,0,1,1,0.06,17,-3
1291,Jamie Collins (F),Clarkson University,17,0,1,1,0.06,0,5
1292,Michael Ufberg (D),Princeton University,17,0,1,1,0.06,2,-4
1293,Joseph Campolieto (D),Union College,17,0,1,1,0.06,10,3
1294,Sean Comrie (D),University of Denver,18,0,1,1,0.06,4,-1
1295,Nick Quillan (D),Colgate University,19,0,1,1,0.05,8,-6
1296,Collin Peters (F),Ohio State University,19,0,1,1,0.05,12,-1
1297,Ross Craig (D),Colgate University,20,0,1,1,0.05,2,2
1298,Matt Thomson (LW),Northeastern University,20,0,1,1,0.05,4,-1
1299,Will Scherer (D),Brown University,22,0,1,1,0.05,0,-1
1300,Jack Randl (LW),University of Michigan,22,0,1,1,0.05,0,-2
1301,Cody Fleckenstein (D),Army (U.S. Military Academy),22,0,1,1,0.05,8,-10
1302,Chris Makowski (F),Mercyhurst University,22,0,1,1,0.05,12,-1
1303,Lawson McDonald (D),University of Nebraska-Omaha,26,0,1,1,0.04,2,-7
1304,Ryan Sidorski (D),Union College,26,0,1,1,0.04,14,3
1305,Andrew Sinard (D),Miami University (Ohio),27,0,1,1,0.04,8,-3
1306,Jack Weiss (D),University of Alaska-Fairbanks,28,0,1,1,0.04,41,-6
1307,Tommy Lee (F),RPI (Rensselaer Polytech. Inst.),29,0,1,1,0.03,14,-4
1308,Adam Baughman (D),Harvard University,29,0,1,1,0.03,21,-5
1309,T.J. Polglaze (F),Michigan Tech,30,0,1,1,0.03,27,-1
1310,Jonathan O'Hara (D),Mercyhurst University,32,0,1,1,0.03,2,-1
1311,Keegan Mantaro (D),Air Force Academy,32,0,1,1,0.03,10,-4
1312,Nolan Nicholas (D),University of Alaska-Anchorage,33,0,1,1,0.03,25,-25
1313,Dorian Dawson (D),Brown University,34,0,1,1,0.03,16,-6
1314,Quinn Wichers (D),Mercyhurst University,35,0,1,1,0.03,32,-4
1315,Tommy Muck (D),Bemidji State University,36,0,1,1,0.03,4,-3
1316,A.J. Vanderbeck (RW),Ohio State University,0,0,0,0,0.00,0,0
1317,Bennet Vida (D),Lake Superior State University,0,0,0,0,0.00,0,0
1318,Ryan Bliss (D),UMass,0,0,0,0,0.00,0,0
1319,Andrew Dumaresque (C),College of the Holy Cross,0,0,0,0,0.00,0,0
1320,Thomas Aldworth (RW/C),University of Vermont,0,0,0,0,0.00,0,0
1321,Jordan Klehr (D),University of Nebraska-Omaha,0,0,0,0,0.00,0,0
1322,Tyler Anderson (D),St. Cloud State University,0,0,0,0,0.00,0,0
1323,J.M. Piotrowski (F),Yale University,0,0,0,0,0.00,0,0
1324,Neil Doef (LW),Princeton University,0,0,0,0,0.00,0,0
1325,Sean King (RW),Niagara University,0,0,0,0,0.00,0,0
1326,Merritt Oszytko (F),RIT (Rochester Inst. of Tech.),0,0,0,0,0.00,0,0
1327,Felix Holmberg (C/RW),University of Notre Dame,0,0,0,0,0.00,0,0
1328,Guus van Nes (LW/RW),Quinnipiac University,0,0,0,0,0.00,0,0
1329,Jack Billings (RW),Niagara University,0,0,0,0,0.00,0,0
1330,Gage Mackie (F),Arizona State University,0,0,0,0,0.00,0,0
1331,Kyle Koopman (D),Providence College,0,0,0,0,0.00,0,0
1332,Michael Rounds (D),Ohio State University,0,0,0,0,0.00,0,0
1333,Christian LeSueur (RW),Dartmouth College,0,0,0,0,0.00,0,0
1334,Jackson Ross (D),Colorado College,0,0,0,0,0.00,0,0
1335,Eric Otto (F),American International College,0,0,0,0,0.00,0,0
1336,Zimeng Chen (D),University of Alabama-Huntsville,0,0,0,0,0.00,0,0
1337,Luke Perunovich (D),Providence College,0,0,0,0,0.00,0,0
1338,Luke Harrington (F),Brown University,0,0,0,0,0.00,0,0
1339,Brett Heikkila (F),Northern Michigan University,0,0,0,0,0.00,0,0
1340,Tanner Lomsnes (F/D),Niagara University,0,0,0,0,0.00,0,0
1341,Nick Azar (D),Harvard University,0,0,0,0,0.00,0,0
1342,Charlie Raith (D),University of Notre Dame,0,0,0,0,0.00,0,0
1343,Filip Engarås (C/RW),University of New Hampshire,0,0,0,0,0.00,0,0
1344,Sam Rennaker (C),University of Maine,0,0,0,0,0.00,0,0
1345,Josh Allan (D),Sacred Heart University,0,0,0,0,0.00,0,0
1346,Dana Engram (C),St. Lawrence University,0,0,0,0,0.00,0,0
1347,D.J. Petruzzelli (F),Quinnipiac University,0,0,0,0,0.00,0,0
1348,Bailey Conger (C/RW),Colorado College,0,0,0,0,0.00,0,0
1349,Griff Jeszka (F),Merrimack College,0,0,0,0,0.00,0,0
1350,Michael Bigelbach (D),Minnesota State University (Mankato),0,0,0,0,0.00,0,0
1351,Kamil Sadlocha (C),Ohio State University,0,0,0,0,0.00,0,0
1352,Rylan Yaremko (D/RW),Northern Michigan University,0,0,0,0,0.00,0,0
1353,Riley Simpson (RW/C),Arizona State University,0,0,0,0,0.00,0,0
1354,Ryan Papa (LW),American International College,0,0,0,0,0.00,0,0
1355,Erik Urbank (RW),Dartmouth College,0,0,0,0,0.00,0,0
1356,Peter Zhong (LW),Arizona State University,0,0,0,0,0.00,0,0
1357,Andong Song (D),Cornell University,0,0,0,0,0.00,0,0
1358,Mitchell Perrault (F),Harvard University,0,0,0,0,0.00,0,0
1359,Ryan Solomon (D),Northeastern University,0,0,0,0,0.00,0,0
1360,Anthony Scarsella (D),Michigan State University,0,0,0,0,0.00,0,0
1361,Mitchell Oliver (D),Lake Superior State University,0,0,0,0,0.00,0,0
1362,Grant Frederic (D),Miami University (Ohio),1,0,0,0,0.00,0,-1
1363,Mikael Hakkarainen (C),Providence College,1,0,0,0,0.00,0,0
1364,Ben DiMaio (D),Dartmouth College,1,0,0,0,0.00,0,0
1365,Cullen Munson (C),University of Minnesota,1,0,0,0,0.00,0,0
1366,Michael Dill (F),UMass-Lowell,1,0,0,0,0.00,0,0
1367,John Wojciechowski (C),University of Connecticut,1,0,0,0,0.00,0,0
1368,Conner Wynne (D),Brown University,1,0,0,0,0.00,0,0
1369,Ryan Orgel (D),University of Denver,1,0,0,0,0.00,0,0
1370,Ian Johnston (LW),Lake Superior State University,1,0,0,0,0.00,0,-1
1371,Trevor St. Jean (F),Bowling Green State University,1,0,0,0,0.00,0,0
1372,Jake Gingell (D),University of Michigan,1,0,0,0,0.00,0,0
1373,Ben Foley (D),Harvard University,1,0,0,0,0.00,0,0
1374,Drew Blackmun (F),Northeastern University,1,0,0,0,0.00,0,0
1375,Brian Matthews (D),Yale University,1,0,0,0,0.00,0,-1
1376,Ryan Schwalbe (C),Minnesota State University (Mankato),1,0,0,0,0.00,2,-1
1377,Teddy Rotenberger (D),University of Alabama-Huntsville,1,0,0,0,0.00,2,-2
1378,Keith Burchett (F),UMass-Lowell,2,0,0,0,0.00,0,-2
1379,Aiden Beck (F),Robert Morris University,2,0,0,0,0.00,0,-1
1380,Alex Carlson (D),Mercyhurst University,2,0,0,0,0.00,0,0
1381,Cameron Ginnetti (D),Clarkson University,2,0,0,0,0.00,0,0
1382,Matthew Acciaioli (D),Northern Michigan University,2,0,0,0,0.00,0,0
1383,Derek Osik (C),UMass-Lowell,2,0,0,0,0.00,0,0
1384,Cole Paskus (F),UMass-Lowell,2,0,0,0,0.00,0,0
1385,Hunter Fargey (RW),Sacred Heart University,2,0,0,0,0.00,0,0
1386,Christian Meike (D),University of Michigan,2,0,0,0,0.00,0,-1
1387,Will Hammer (F),St. Cloud State University,2,0,0,0,0.00,0,-1
1388,Derek Hamelin (D),Canisius College,2,0,0,0,0.00,2,0
1389,Jake Rosenbaum (D),University of Minnesota-Duluth,2,0,0,0,0.00,2,-2
1390,Tyrell Buckley (D),Michigan Tech,2,0,0,0,0.00,4,1
1391,Marcus Chorney (D),Quinnipiac University,3,0,0,0,0.00,0,1
1392,Edward Lindelöw (C),University of Maine,3,0,0,0,0.00,0,-1
1393,Gianluca Esteves (F),Michigan State University,3,0,0,0,0.00,0,-2
1394,Jack Rowe (F),Arizona State University,3,0,0,0,0.00,0,0
1395,Connor Stuart (D/F),Arizona State University,3,0,0,0,0.00,0,0
1396,Chaz Switzer (D),Miami University (Ohio),3,0,0,0,0.00,2,0
1397,Lukas Samuelsson (F),Western Michigan University,3,0,0,0,0.00,4,0
1398,Matt Jennings (C),Ohio State University,4,0,0,0,0.00,0,0
1399,Joey Marooney (RW),University of Minnesota,4,0,0,0,0.00,0,0
1400,Jonathan Barry (D),Providence College,4,0,0,0,0.00,0,0
