ID,Player,Team,GP,G,A,TP,PPG,PIM,PM
1,Cole Caufield (LW/RW),University of Wisconsin,31,30,22,52,1.68,4,9
2,Odeen Tufto (C),Quinnipiac University,29,8,39,47,1.62,22,8
3,Linus Weissbach (LW),University of Wisconsin,31,12,29,41,1.32,12,7
4,Jordan Kawaguchi (C),University of North Dakota,28,10,26,36,1.29,24,19
5,Dylan Holloway (W/C),University of Wisconsin,23,11,24,35,1.52,19,10
6,Collin Adams (LW/C),University of North Dakota,29,14,20,34,1.17,10,22
7,Bobby Trivigno (LW),UMass,29,11,23,34,1.17,12,21
8,Brandon Kruse (LW),Bowling Green State University,31,11,23,34,1.10,26,29
9,Joseph Nardi (C/LW),Northern Michigan University,29,12,21,33,1.14,0,1
10,Shane Pinto (C),University of North Dakota,28,15,17,32,1.14,4,19
11,Alex Steeves (LW/C),University of Notre Dame,29,15,17,32,1.10,8,2
12,Sampo Ranta (LW/RW),University of Minnesota,31,19,12,31,1.00,10,19
13,Ty Pelton-Byce (F),University of Wisconsin,24,12,19,31,1.29,2,7
14,Matt Boldy (LW/RW),Boston College,22,11,20,31,1.41,4,15
15,Thomas Bordeleau (C/LW),University of Michigan,24,8,22,30,1.25,12,18
16,Ashton Calder (F),Lake Superior State University,29,16,13,29,1.00,20,17
17,Jonny Evans (F),University of Connecticut,23,14,15,29,1.26,12,8
18,Ethan De Jong (RW/LW),Quinnipiac University,29,14,15,29,1.00,22,6
19,Sammy Walker (C/RW),University of Minnesota,31,13,16,29,0.94,12,14
20,Cameron Wright (RW),Bowling Green State University,31,13,16,29,0.94,32,26
21,Connor Ford (C),Bowling Green State University,31,16,12,28,0.90,10,4
22,Nick Swaney (RW),University of Minnesota-Duluth,28,13,15,28,1.00,10,5
23,Blake McLaughlin (LW/C),University of Minnesota,31,12,16,28,0.90,8,9
24,Ben Meyers (C/LW),University of Minnesota,31,12,16,28,0.90,12,15
25,Scott Reedy (C),University of Minnesota,28,11,17,28,1.00,6,20
26,Andre Ghantous (RW/LW),Northern Michigan University,25,10,18,28,1.12,16,1
27,Julian Napravnik (RW),Minnesota State University (Mankato),27,10,18,28,1.04,4,15
28,A.J. Vanderbeck (RW),Northern Michigan University,29,14,13,27,0.93,22,0
29,Pierre-Luc Veillette (C),Lake Superior State University,29,13,14,27,0.93,4,22
30,Jackson Cates (C/LW),University of Minnesota-Duluth,28,11,16,27,0.96,4,8
31,Kent Johnson (LW/C),University of Michigan,26,9,18,27,1.04,4,16
32,Oliver Chau (C),UMass,29,5,22,27,0.93,4,9
33,Zach Metsa (D),Quinnipiac University,29,5,21,26,0.90,8,7
34,Colin Bilek (RW),Army (U.S. Military Academy),22,18,7,25,1.14,20,12
35,Will Calverley (C),RIT (Rochester Inst. of Tech.),18,12,13,25,1.39,4,2
36,Trenton Bliss (LW/C),Michigan Tech,29,12,13,25,0.86,27,-2
37,Randy Hernández (RW),Robert Morris University,24,11,14,25,1.04,2,0
38,Tyce Thompson (RW/C),Providence College,25,11,14,25,1.00,16,-2
39,Jackson Pierson (C),University of New Hampshire,23,9,16,25,1.09,4,0
40,Brannon McManus (C/RW),University of Minnesota,27,9,16,25,0.93,0,11
41,Nathan Smith (C),Minnesota State University (Mankato),28,9,16,25,0.89,16,7
42,Nick Prkusic (F),Robert Morris University,24,7,18,25,1.04,12,4
43,Graham Slaggert (C/LW),University of Notre Dame,27,7,18,25,0.93,10,4
44,Will Cullen (D),Bowling Green State University,28,6,19,25,0.89,54,20
45,Carson Gicewicz (C),UMass,28,17,7,24,0.86,37,8
46,Jasper Weatherby (C/LW),University of North Dakota,29,14,10,24,0.83,8,7
47,Zach Solow (C/RW),Northeastern University,21,11,13,24,1.14,30,1
48,Veeti Miettinen (RW),St. Cloud State University,31,11,13,24,0.77,0,5
49,Matty Beniers (C),University of Michigan,24,10,14,24,1.00,0,21
50,Marc McLaughlin (C/RW),Boston College,24,10,14,24,1.00,6,16
51,Max Johnson (C),Bowling Green State University,27,10,14,24,0.89,8,14
52,Nolan Walker (C),St. Cloud State University,31,10,14,24,0.77,8,3
53,Cade Borchardt (F),Minnesota State University (Mankato),28,9,15,24,0.86,10,14
54,Zac Jones (D),UMass,29,9,15,24,0.83,8,17
55,Alex Ierullo (LW),Bemidji State University,29,7,17,24,0.83,18,4
56,Cole Koepke (LW/RW/RW),University of Minnesota-Duluth,28,15,8,23,0.82,22,3
57,Kobe Roth (F),University of Minnesota-Duluth,28,13,10,23,0.82,2,10
58,Jami Krannila (C),St. Cloud State University,31,11,12,23,0.74,18,8
59,Matt Kessel (D),UMass,29,10,13,23,0.79,16,15
60,Chayse Primeau (W/C),University of Nebraska-Omaha,26,9,14,23,0.88,4,2
61,Josh Lopina (C/RW),UMass,29,9,14,23,0.79,12,20
62,Brendan Harris (C/LW),Bemidji State University,29,9,14,23,0.79,17,0
63,Alex Barber (F),Bowling Green State University,31,9,14,23,0.74,35,10
64,Grant Hebert (C),Robert Morris University,24,8,15,23,0.96,18,6
65,Tyler Weiss (LW/C),University of Nebraska-Omaha,26,7,16,23,0.88,36,10
66,Nick Perbix (D),St. Cloud State University,31,7,16,23,0.74,16,8
67,Drew Worrad (C),Western Michigan University,25,5,18,23,0.92,8,0
68,Taylor Ward (RW),University of Nebraska-Omaha,26,13,9,22,0.85,20,2
69,Alex Limoges (LW/C),Penn State University,22,10,12,22,1.00,2,-7
70,Elijah Gonsalves (RW/C),RIT (Rochester Inst. of Tech.),20,9,13,22,1.10,22,-7
71,Roman Ahcan (LW/C),University of Wisconsin,26,9,13,22,0.85,43,7
72,Cole Guttman (C/RW),University of Denver,23,8,14,22,0.96,12,-2
73,Ronnie Attard (D),Western Michigan University,25,8,14,22,0.88,8,-3
74,Landon Slaggert (LW/C),University of Notre Dame,25,8,14,22,0.88,10,-1
75,Zachary Okabe (RW),St. Cloud State University,30,6,16,22,0.73,12,6
76,Jáchym Kondelík (C/W),University of Connecticut,23,4,18,22,0.96,6,0
77,Matt Kiersted (D),University of North Dakota,29,3,19,22,0.76,28,15
78,Ty Smilanic (C),Quinnipiac University,29,14,7,21,0.72,10,0
79,Ethen Frank (RW/C),Western Michigan University,24,13,8,21,0.88,4,-2
80,Alec Broetzman (LW),Michigan Tech,30,13,8,21,0.70,16,-1
81,Riese Gaber (RW/LW),University of North Dakota,29,11,10,21,0.72,41,8
82,Brendan Brisson (LW/RW),University of Michigan,24,10,11,21,0.88,18,10
83,Reggie Lutz (RW),Minnesota State University (Mankato),25,10,11,21,0.84,33,8
84,Paul Washe (C),Western Michigan University,25,8,13,21,0.84,18,7
85,Jake Hamacher (LW),RIT (Rochester Inst. of Tech.),20,7,14,21,1.05,4,-9
86,Jackson LaCombe (D),University of Minnesota,27,4,17,21,0.78,8,19
87,Ethan Somoza (LW),Bemidji State University,29,15,5,20,0.69,14,3
88,Carter Savoie (LW),University of Denver,24,13,7,20,0.83,23,0
89,Aidan McDonough (LW/RW),Northeastern University,21,10,10,20,0.95,4,-3
90,Travis Treloar (C),Ohio State University,25,8,12,20,0.80,4,-3
91,Koby Bender (RW/C),University of Minnesota-Duluth,28,7,13,20,0.71,21,13
92,Peter DiLiberatore (D),Quinnipiac University,29,6,14,20,0.69,36,2
93,Cam York (D),University of Michigan,24,4,16,20,0.83,4,13
94,Matt Kopperud (C),Arizona State University,25,13,6,19,0.76,8,-19
95,Grant Mismash (LW/C),University of North Dakota,20,10,9,19,0.95,35,8
96,Mike Hardman (W/C),Boston College,24,10,9,19,0.79,14,5
97,Taylor Schneider (LW),Bowling Green State University,31,10,9,19,0.61,8,9
98,Kevin Conley (LW/C),University of Nebraska-Omaha,25,9,10,19,0.76,39,-9
99,Dallas Gerads (C/LW),Minnesota State University (Mankato),28,9,10,19,0.68,31,12
100,Kevin Wall (RW),Penn State University,22,8,11,19,0.86,4,1
101,Nikita Nesterenko (C/LW),Boston College,24,8,11,19,0.79,18,12
102,Louis Boudon (C),Lake Superior State University,27,8,11,19,0.70,14,12
103,Parker Ford (C/RW),Providence College,25,7,12,19,0.76,14,1
104,Josh Passolt (LW),Western Michigan University,25,7,12,19,0.76,14,-1
105,Jordan Harris (D),Northeastern University,19,6,13,19,1.00,8,-5
106,Nick Jenny (D),Robert Morris University,24,6,13,19,0.79,4,2
107,Jack McBain (C/LW),Boston College,24,6,13,19,0.79,12,14
108,Hampus Eriksson (C/W),Lake Superior State University,29,6,13,19,0.66,16,8
109,Carson Brière (C/RW),Mercyhurst University,21,5,14,19,0.90,10,1
110,Mason Krueger (F),Army (U.S. Military Academy),21,5,14,19,0.90,18,9
111,Mark Cheremeta (LW),Ohio State University,27,5,14,19,0.70,4,-16
112,Noah Cates (LW),University of Minnesota-Duluth,28,5,14,19,0.68,25,6
113,Christopher Theodore (LW),American International College,19,4,15,19,1.00,2,6
114,Easton Brodzinski (RW/LW),St. Cloud State University,29,13,5,18,0.62,46,-1
115,Tobias Fladeby (LW/RW),American International College,16,10,8,18,1.13,0,5
116,Keaton Mastrodonato (RW/C),Canisius College,17,9,9,18,1.06,4,10
117,Angus Crookshank (LW/RW),University of New Hampshire,20,9,9,18,0.90,4,2
118,Kevin Fitzgerald (C),St. Cloud State University,31,9,9,18,0.58,22,2
119,Tim Doherty (C/LW),Penn State University,22,8,10,18,0.82,4,-3
120,Brian Halonen (LW/RW),Michigan Tech,28,8,10,18,0.64,16,6
121,Chris Dodero (C/LW),American International College,19,7,11,18,0.95,16,12
122,Kalle Eriksson (D),University of New Hampshire,23,6,12,18,0.78,2,-12
123,Cole Gallant (C),Western Michigan University,25,5,13,18,0.72,2,3
124,Dan Willett (D),RIT (Rochester Inst. of Tech.),20,4,14,18,0.90,8,-9
125,Zach Tsekos (C),Clarkson University,22,4,14,18,0.82,4,4
126,Jacob Bernard-Docker (D),University of North Dakota,27,3,15,18,0.67,20,17
127,Arvid Caderoth (C/RW),Michigan Tech,30,2,16,18,0.60,12,-3
128,Brennan Kapcheck (D),American International College,19,0,18,18,0.95,10,12
129,Walker Duehr (RW),Minnesota State University (Mankato),28,10,7,17,0.61,26,9
130,Anthony Callin (RW/D),Clarkson University,22,9,8,17,0.77,16,9
131,Garrett Wait (LW),UMass,29,9,8,17,0.59,10,19
132,Coale Norris (LW),Ferris State University,25,8,9,17,0.68,4,-12
133,Sam Hentges (C/LW),St. Cloud State University,29,8,9,17,0.59,14,-1
134,Jakov Novak (LW/C),Bentley University,15,7,10,17,1.13,36,5
135,Brock Caufield (RW),University of Wisconsin,31,7,10,17,0.55,0,-4
136,Eric Butte (F),Army (U.S. Military Academy),22,6,11,17,0.77,16,8
137,Will Riedell (D),Lake Superior State University,29,6,11,17,0.59,18,8
138,Nick Leivermann (D),University of Notre Dame,29,5,12,17,0.59,6,10
139,Alexander Campbell (LW/C),Clarkson University,22,4,13,17,0.77,2,10
140,Owen Lindmark (C/RW),University of Wisconsin,27,4,13,17,0.63,4,2
141,Colin Swoyer (D),Michigan Tech,30,3,14,17,0.57,24,9
142,Brandon Scanlin (D),University of Nebraska-Omaha,24,2,15,17,0.71,14,-5
143,Matt Barry (F),Miami University (Ohio),25,2,15,17,0.68,6,-10
144,Desi Burgart (F),Quinnipiac University,29,10,6,16,0.55,16,8
145,Justin Cole (F),American International College,18,9,7,16,0.89,0,9
146,Jay O'Brien (C),Boston University,16,8,8,16,1.00,8,5
147,Alex Newhook (C/LW),Boston College,12,7,9,16,1.33,8,-1
148,Andre Lee (LW/C),UMass-Lowell,20,7,9,16,0.80,18,7
149,Marc Johnstone (RW/LW),Sacred Heart University,16,6,10,16,1.00,12,-8
150,Braeden Tuck (F),Sacred Heart University,18,6,10,16,0.89,0,-4
151,David Farrance (D),Boston University,11,5,11,16,1.45,4,1
152,Luke Santerno (F),Bentley University,15,5,11,16,1.07,34,3
153,Mitch Machlitt (C),Army (U.S. Military Academy),22,5,11,16,0.73,2,9
154,Max Ellis (RW),University of Notre Dame,24,5,11,16,0.67,8,8
155,Elias Rosén (D),Bemidji State University,25,5,11,16,0.64,10,1
156,Michael Lombardi (C/LW),Quinnipiac University,26,5,11,16,0.62,0,11
157,James Sanchez (LW),Arizona State University,26,5,11,16,0.62,8,-3
158,Nick Bruce (F),RIT (Rochester Inst. of Tech.),18,4,12,16,0.89,14,4
159,Jake Jaremko (LW/C),Minnesota State University (Mankato),28,4,12,16,0.57,2,11
160,Owen Power (D),University of Michigan,26,3,13,16,0.62,6,18
161,Jonathan Bendorf (LW),Mercyhurst University,21,11,4,15,0.71,2,1
162,Owen Sillinger (C/LW),Bemidji State University,20,10,5,15,0.75,14,3
163,Walker Sommer (C),Niagara University,18,8,7,15,0.83,19,3
164,Justin Addamo (C/RW),Robert Morris University,21,8,7,15,0.71,53,0
165,Brandon Puricelli (RW),Lake Superior State University,28,8,7,15,0.54,37,-3
166,Matt Gosiewski (C),Bentley University,16,7,8,15,0.94,2,-3
167,Patrick Grasso (RW),University of New Hampshire,23,7,8,15,0.65,2,-7
168,Colby Ambrosio (C/RW),Boston College,24,7,8,15,0.63,6,9
169,Mitchell Martan (LW),Canisius College,16,6,9,15,0.94,21,8
170,Patrick Moynihan (RW),Providence College,17,6,9,15,0.88,8,6
171,Gunnarwolfe Fontaine (LW/C),Northeastern University,21,6,9,15,0.71,29,-7
172,Connor McMenamin (LW),Penn State University,22,6,9,15,0.68,4,8
173,Greg Printz (LW/RW),Providence College,25,6,9,15,0.60,12,-4
174,Lukas Sillinger (W/C),Bemidji State University,28,6,9,15,0.54,46,-5
175,Griffin Loughran (F),Northern Michigan University,16,5,10,15,0.94,38,8
176,Cameron Buhl (F),St. Lawrence University,17,5,10,15,0.88,19,1
177,Reid Stefanson (C/LW),UMass-Lowell,19,5,10,15,0.79,4,3
178,Dante Sheriff (RW),Mercyhurst University,19,5,10,15,0.79,31,0
179,Tim Theocharidis (D),Bowling Green State University,31,5,10,15,0.48,8,1
180,Jaxon Nelson (C/RW),University of Minnesota,31,5,10,15,0.48,34,9
181,Jack Jacome (RW/LW),Clarkson University,22,4,11,15,0.68,2,0
182,Drew Helleson (D),Boston College,22,4,11,15,0.68,8,23
183,Casey Gilling (C),Miami University (Ohio),23,4,11,15,0.65,16,-9
184,Brendon Michaelian (D),Robert Morris University,24,4,11,15,0.63,8,12
185,Spencer Meier (D),St. Cloud State University,31,4,11,15,0.48,6,9
186,Grant Jozefek (RW),Northeastern University,21,3,12,15,0.71,16,2
187,Jacob Nordqvist (D),Lake Superior State University,29,3,12,15,0.52,10,22
188,Jake Sanderson (D),University of North Dakota,22,2,13,15,0.68,4,20
189,Lukas Kälble (D),Lake Superior State University,27,2,13,15,0.56,16,19
190,Guus van Nes (LW/RW),Quinnipiac University,29,2,13,15,0.52,12,4
191,Akito Hirose (D),Minnesota State University (Mankato),28,1,14,15,0.54,14,18
192,Anthony Romano (C/RW),Clarkson University,22,9,5,14,0.64,10,-1
193,Grant Cooper (LW),Clarkson University,22,8,6,14,0.64,10,7
194,Colin Theisen (C),University of Notre Dame,27,8,6,14,0.52,49,-2
195,Bryce Brodzinski (RW),University of Minnesota,30,8,6,14,0.47,10,6
196,Ludwig Stenlund (C),Niagara University,17,7,7,14,0.82,2,-5
197,Austin Magera (C),Sacred Heart University,17,7,7,14,0.82,10,1
198,Jason Polin (RW),Western Michigan University,23,7,7,14,0.61,4,-5
199,Kobe Walker (RW),RIT (Rochester Inst. of Tech.),17,6,8,14,0.82,4,4
200,Hudson Schandor (C),University of Connecticut,22,6,8,14,0.64,10,2
201,Jake Transit (F),Ferris State University,24,6,8,14,0.58,44,-5
202,Ethan Stewart (F),Ferris State University,25,6,8,14,0.56,2,-1
203,Chris Grando (LW),Arizona State University,25,6,8,14,0.56,6,-1
204,Aaron Miller (F),Bemidji State University,27,6,8,14,0.52,10,4
205,Adam Dawe (RW/C),University of Maine,16,5,9,14,0.88,23,-6
206,Santeri Hartikainen (C/RW),Robert Morris University,21,5,9,14,0.67,6,-8
207,Dylan Jackson (RW),Northeastern University,21,5,9,14,0.67,8,1
208,Thomas Farrell (D),Army (U.S. Military Academy),22,5,9,14,0.64,10,6
209,Nick Poisson (F),Providence College,24,5,9,14,0.58,23,0
210,Todd Burgess (C/W),Minnesota State University (Mankato),25,5,9,14,0.56,6,7
211,Matthew Barbolini (C/LW),Miami University (Ohio),25,5,9,14,0.56,14,-8
212,Miroslav Mucha (RW),Lake Superior State University,29,5,9,14,0.48,4,7
213,Johnny Walker (RW),Arizona State University,16,4,10,14,0.88,21,-4
214,Kohen Olischefski (RW),University of Denver,23,4,10,14,0.61,21,-4
215,Michael Joyaux (D),Western Michigan University,25,4,10,14,0.56,8,-13
216,Jake Livingstone (D),Minnesota State University (Mankato),28,4,10,14,0.50,16,15
217,Michael Callahan (D),Providence College,25,3,11,14,0.56,12,-3
218,Mark Senden (C/LW),University of North Dakota,26,3,11,14,0.54,10,10
219,Marc Del Gaizo (D),UMass,27,3,11,14,0.52,4,21
220,Mike Van Unen (D),Northern Michigan University,29,3,11,14,0.48,47,-17
221,Eric Gotz (D),Michigan Tech,30,3,11,14,0.47,12,-11
222,Eamon Powell (D),Boston College,24,2,12,14,0.58,6,12
223,Ryan Johnson (D),University of Minnesota,27,2,12,14,0.52,12,15
224,John Zimmerman (D),Army (U.S. Military Academy),21,1,13,14,0.67,24,11
225,T.J. Lloyd (D),Bowling Green State University,31,0,14,14,0.45,26,14
226,Carter Turnbull (RW/C),University of Connecticut,23,9,4,13,0.57,10,-7
227,Matt Brown (LW/RW),UMass-Lowell,19,8,5,13,0.68,10,0
228,Matt Miller (RW),University of Nebraska-Omaha,26,8,5,13,0.50,2,-4
229,Elijiah Barriga (C),American International College,16,7,6,13,0.81,6,12
230,Jack Billings (RW),Niagara University,20,7,6,13,0.65,6,-3
231,Aarne Talvitie (C/LW),Penn State University,21,7,6,13,0.62,6,3
232,Josh McKechney (F),Colgate University,22,7,6,13,0.59,12,2
233,Alex Young (C/W),Colgate University,21,6,7,13,0.62,17,-5
234,Nick Lalonde (RW),Robert Morris University,24,6,7,13,0.54,6,4
235,Brock Bremer (LW),University of Nebraska-Omaha,25,6,7,13,0.52,10,-3
236,Quinn Preston (F),Ohio State University,27,6,7,13,0.48,12,-13
237,Mitch Lewandowski (LW),Michigan State University,27,6,7,13,0.48,28,-1
238,Jack Gorniak (LW/C),University of Wisconsin,31,6,7,13,0.42,8,-1
239,Josiah Slavin (LW/RW),Colorado College,22,5,8,13,0.59,4,-5
240,Anthony Firriolo (D),Army (U.S. Military Academy),22,5,8,13,0.59,16,9
241,Jack Randl (LW),University of Nebraska-Omaha,24,5,8,13,0.54,8,0
242,Nick Blankenburg (D),University of Michigan,26,5,8,13,0.50,14,19
243,Brendan Furry (LW/RW),Minnesota State University (Mankato),28,5,8,13,0.46,19,7
244,Jake Gaudet (C),UMass,28,5,8,13,0.46,31,13
245,Filip Forsmark (LW/RW),Merrimack College,18,4,9,13,0.72,16,-4
246,Gueorgui Feduolov (F),Mercyhurst University,21,4,9,13,0.62,16,-1
247,Tyrone Bronte (RW),University of Alabama-Huntsville,22,4,9,13,0.59,8,-7
248,Lincoln Hatten (F),Army (U.S. Military Academy),22,4,9,13,0.59,8,5
249,Ty Emberson (D),University of Wisconsin,31,4,9,13,0.42,6,14
250,Gavin Gould (C/LW),Bowling Green State University,21,3,10,13,0.62,6,7
251,Ryan Naumovski (F),Niagara University,22,3,10,13,0.59,0,0
252,Ryan O'Reilly (W/C),Arizona State University,23,3,10,13,0.57,8,-6
253,Grant Gabriele (D),Ohio State University,27,3,10,13,0.48,0,-26
254,Jason Smallidge (D),University of Nebraska-Omaha,26,2,11,13,0.50,16,6
255,Joey Maziarz (D),Mercyhurst University,20,1,12,13,0.65,8,9
256,Riese Zmolek (D),Minnesota State University (Mankato),24,1,12,13,0.54,27,12
257,Kevin Lombardi (RW/LW),Sacred Heart University,17,8,4,12,0.71,2,3
258,Austin Heidemann (F),Mercyhurst University,16,7,5,12,0.75,9,2
259,Liam Walsh (LW),Merrimack College,17,7,5,12,0.71,10,0
260,Tristan Ashbrook (C/RW),Michigan Tech,20,7,5,12,0.60,0,4
261,Ty Jackson (C),Northeastern University,21,7,5,12,0.57,16,3
262,Eric Ciccolini (RW),University of Michigan,24,7,5,12,0.50,8,11
263,Vincent De Mey (F),Northern Michigan University,26,7,5,12,0.46,16,-14
264,Willie Reim (F),Air Force Academy,14,6,6,12,0.86,10,-8
265,Alden Dupuis (F),RIT (Rochester Inst. of Tech.),19,6,6,12,0.63,2,-7
266,Charles Levesque (C),UMass-Lowell,20,6,6,12,0.60,2,11
267,Daniel Haider (F),Army (U.S. Military Academy),22,6,6,12,0.55,2,8
268,Mathieu Gosselin (RW/LW),Clarkson University,22,6,6,12,0.55,20,14
269,Marc Gatcomb (C/RW),University of Connecticut,23,6,6,12,0.52,14,0
270,Bauer Neudecker (F),University of Alabama-Huntsville,22,5,7,12,0.55,0,-4
271,Brandon Schultz (C/LW),Northern Michigan University,25,5,7,12,0.48,14,6
272,Spencer Stastney (D),University of Notre Dame,29,5,7,12,0.41,6,5
273,David Jankowski (C/RW),St. Lawrence University,15,4,8,12,0.80,0,1
274,Ryan Steele (F),Sacred Heart University,17,4,8,12,0.71,12,-1
275,Derek Daschke (D),Miami University (Ohio),25,4,8,12,0.48,6,-17
276,Sam Craggs (LW),Bowling Green State University,27,4,8,12,0.44,55,3
277,Justin Misiak (C),Michigan Tech,28,4,8,12,0.43,8,0
278,Yuki Miura (C/RW),Lake Superior State University,29,4,8,12,0.41,4,7
279,Vladislav Firstov (LW),University of Connecticut,13,3,9,12,0.92,12,3
280,Patrick Giles (C/RW),Boston College,24,3,9,12,0.50,16,8
281,Tarek Baker (LW),University of Wisconsin,27,3,9,12,0.44,24,6
282,Mike Koster (D),University of Minnesota,31,3,9,12,0.39,2,10
283,Drew Bavaro (D),Bentley University,16,2,10,12,0.75,8,4
284,Jayden Struble (D),Northeastern University,18,2,10,12,0.67,33,-2
285,Dennis Cesana (D),Michigan State University,27,2,10,12,0.44,10,-7
286,Croix Evingson (D),Niagara University,21,1,11,12,0.57,16,-6
287,Ben Mirageas (D),Providence College,25,1,11,12,0.48,20,7
288,Brock Faber (D),University of Minnesota,27,1,11,12,0.44,14,17
289,Aaron Bohlinger (D),UMass,29,1,11,12,0.41,6,4
290,Brian Kramer (D),Robert Morris University,22,0,12,12,0.55,32,1
291,Jordan Timmons (F),Robert Morris University,13,9,2,11,0.85,4,7
292,Evan Dougherty (RW),Bowling Green State University,31,8,3,11,0.35,20,3
293,Kaden Pickering (RW),St. Lawrence University,17,7,4,11,0.65,6,2
294,Ryan Cox (F),Niagara University,22,7,4,11,0.50,18,-7
295,Mitchel Deelstra (LW/C),Ferris State University,25,7,4,11,0.44,18,-12
296,Justin Michaelian (F),Ferris State University,14,6,5,11,0.79,17,-5
297,Luke Tuch (LW),Boston University,16,6,5,11,0.69,12,0
298,Chase Blackmun (D),UMass-Lowell,19,6,5,11,0.58,8,3
299,Filip Engarås (C/RW),University of New Hampshire,22,6,5,11,0.50,21,-6
300,Christophe Fillion (F),Quinnipiac University,25,6,5,11,0.44,4,7
301,Tate Singleton (C),Ohio State University,27,6,5,11,0.41,10,-13
302,Marcel Godbout (C/RW),Sacred Heart University,18,5,6,11,0.61,6,-11
303,Christian Sarlo (F),Penn State University,21,5,6,11,0.52,2,-2
304,Aidan Spellacy (F),Robert Morris University,24,5,6,11,0.46,6,-3
305,Ty Glover (LW/C),Western Michigan University,24,5,6,11,0.46,10,-12
306,Nick Granowicz (C/RW),University of Michigan,25,5,6,11,0.44,10,18
307,Alex Frye (C),Northern Michigan University,25,5,6,11,0.44,14,0
308,Logan Hutsko (RW/C),Boston College,11,4,7,11,1.00,10,11
309,Ben Copeland (C),Colorado College,22,4,7,11,0.50,18,-10
310,Judd Caulfield (RW/LW),University of North Dakota,26,4,7,11,0.42,2,11
311,Jesse Lansdell (LW),University of Notre Dame,28,4,7,11,0.39,10,-1
312,Tyler Rockwell (D),Michigan Tech,30,4,7,11,0.37,12,3
313,Carl Berglund (C/LW),UMass-Lowell,11,3,8,11,1.00,2,-1
314,Grant Meyer (RW),Canisius College,13,3,8,11,0.85,8,-1
315,Lynden Breen (C/LW),University of Maine,16,3,8,11,0.69,6,-10
316,Mike Benning (D),University of Denver,21,3,8,11,0.52,8,-1
317,John Spetz (D),University of Connecticut,22,3,8,11,0.50,10,3
318,Marshall Warren (D),Boston College,23,3,8,11,0.48,27,13
319,Josh Nodler (C/RW),Michigan State University,27,3,8,11,0.41,0,0
320,Quinn Olson (LW/C),University of Minnesota-Duluth,28,3,8,11,0.39,16,3
321,Bobby Brink (RW),University of Denver,15,2,9,11,0.73,4,-4
322,Seth Barton (D),UMass-Lowell,20,2,9,11,0.55,4,-9
323,Connor MacEachern (C),Penn State University,21,2,9,11,0.52,6,-4
324,Lucas Finner (LW),Ferris State University,21,2,9,11,0.52,24,-16
325,Antti Tuomisto (D),University of Denver,24,2,9,11,0.46,23,-2
326,David Keefer (RW),Northern Michigan University,28,2,9,11,0.39,8,-7
327,Skyler Brind'Amour (C/LW),Quinnipiac University,29,2,9,11,0.38,23,0
328,Jakub Sirota (D),University of Maine,16,1,10,11,0.69,4,0
329,Jacob Semik (D),Arizona State University,25,1,10,11,0.44,4,-12
330,Aidan Fulp (D),Western Michigan University,25,0,11,11,0.44,12,-6
331,Grant Cruikshank (C/LW),Colorado College,16,8,2,10,0.63,4,-2
332,Eduards Tralmaks (W/C),University of Maine,12,6,4,10,0.83,26,2
333,Caleb Moretz (RW/C),RIT (Rochester Inst. of Tech.),15,6,4,10,0.67,8,-8
334,Lucas Condotta (C),UMass-Lowell,20,6,4,10,0.50,14,-7
335,Riley Hughes (RW),Northeastern University,21,6,4,10,0.48,4,-8
336,Charlie Combs (LW),Michigan State University,23,6,4,10,0.43,21,-4
337,Trevor Kuntar (C/LW),Boston College,23,6,4,10,0.43,33,2
338,Martin Sundberg (RW),University of Nebraska-Omaha,24,6,4,10,0.42,37,7
339,Michael Mancinelli (C),Arizona State University,26,6,4,10,0.38,8,-16
340,Logan Cockerill (LW/RW),Boston University,12,5,5,10,0.83,6,9
341,Eric MacAdams (RW),University of New Hampshire,16,5,5,10,0.63,31,1
342,Lee Lapid (C),Canisius College,17,5,5,10,0.59,10,0
343,Brett Berard (LW),Providence College,19,5,5,10,0.53,16,-3
344,Tucker DeYoung (F),Army (U.S. Military Academy),21,5,5,10,0.48,21,2
345,Jax Murray (F),Arizona State University,22,5,5,10,0.45,0,0
346,Ross Armour (C/RW),Bemidji State University,29,5,5,10,0.34,6,4
347,Alex Jefferies (LW),Merrimack College,12,4,6,10,0.83,2,-4
348,Zak Galambos (D),American International College,16,4,6,10,0.63,16,10
349,Matthew Verboon (RW/C),Colgate University,22,4,6,10,0.45,14,-4
350,Demetrios Koumontzis (LW/D),Arizona State University,22,4,6,10,0.45,14,-8
351,Trevor Janicke (RW/C),University of Notre Dame,29,4,6,10,0.34,4,5
352,Michael Zuffante (F),Bentley University,15,3,7,10,0.67,8,-4
353,Luc Salem (D),St. Lawrence University,17,3,7,10,0.59,14,5
354,Griffin Lunn (F),Colgate University,22,3,7,10,0.45,14,1
355,Ethan Frisch (D),University of North Dakota,24,3,7,10,0.42,12,17
356,Mitchell Oliver (D),Lake Superior State University,25,3,7,10,0.40,8,2
357,Ethan Leyh (F),Quinnipiac University,25,3,7,10,0.40,10,2
358,Tanner Laderoute (RW/C),University of Minnesota-Duluth,28,3,7,10,0.36,11,2
359,Tyler Kirkup (C/LW),Bemidji State University,29,3,7,10,0.34,14,7
360,Bradley Johnson (D),Bemidji State University,29,3,7,10,0.34,20,-6
361,Micah Miller (RW/C),St. Cloud State University,31,3,7,10,0.32,14,0
362,Declan Carlile (D),Merrimack College,14,2,8,10,0.71,10,0
363,Michael Graham (F),University of Notre Dame,18,2,8,10,0.56,8,2
364,Jimmy Dowd (D),Penn State University,20,2,8,10,0.50,4,7
365,Ryan Verrier (D),University of New Hampshire,23,2,8,10,0.43,24,-2
366,Blake Evennou (D),Ferris State University,25,1,9,10,0.40,10,-17
367,Tyler Vold (D),Bemidji State University,29,1,9,10,0.34,2,-9
368,Ondrej Trejbal (D),St. Cloud State University,29,1,9,10,0.34,10,-1
369,Carson Musser (D),Bowling Green State University,31,1,9,10,0.32,8,12
370,Pierson Brandon (D),Colgate University,22,0,10,10,0.45,16,10
371,Wyatt Kaiser (D),University of Minnesota-Duluth,28,0,10,10,0.36,26,2
372,Colin Felix (D),UMass,29,0,10,10,0.34,32,20
373,Michael Pastujov (LW),University of Michigan,24,7,2,9,0.38,10,8
374,Ryan Sandelin (RW/C),Minnesota State University (Mankato),27,7,2,9,0.33,28,10
375,Brendan Hamblet (F),Bentley University,15,6,3,9,0.60,6,3
376,Gustaf Westlund (C/W),Ohio State University,23,6,3,9,0.39,50,-11
377,Gavin Hain (C/LW),University of North Dakota,28,6,3,9,0.32,17,5
378,Simon Gravel (C/RW),Canisius College,13,5,4,9,0.69,0,2
379,Hank Crone (RW/LW),University of Denver,13,5,4,9,0.69,4,6
380,Sam Morton (C/LW),Minnesota State University (Mankato),17,5,4,9,0.53,6,11
381,Willie Knierim (RW),Arizona State University,18,5,4,9,0.50,12,-2
382,Jake Joffe (RW),RIT (Rochester Inst. of Tech.),20,5,4,9,0.45,0,-5
383,Cal Kiefiuk (F),UMass,22,5,4,9,0.41,8,-1
384,Tommy Apap (C/LW),Michigan State University,25,5,4,9,0.36,8,-9
385,Alex Peterson (F),College of the Holy Cross,12,4,5,9,0.75,23,-1
386,Brendan Walkom (C/LW),Bentley University,13,4,5,9,0.69,0,-5
387,Emil Westerlund (LW/RW),University of Maine,16,4,5,9,0.56,14,-13
388,Gregory Lapointe (F),St. Lawrence University,17,4,5,9,0.53,6,3
389,Benito Posa (F),Lake Superior State University,20,4,5,9,0.45,28,4
390,Matthew Fawcett (LW),Quinnipiac University,21,4,5,9,0.43,0,5
391,Jack Becker (C/RW),University of Michigan,23,4,5,9,0.39,2,8
392,Ryan Barrow (RW),University of Denver,24,4,5,9,0.38,10,3
393,Benji Eckerle (F),Arizona State University,25,4,5,9,0.36,14,1
394,Nolan Sullivan (F),University of Nebraska-Omaha,26,4,5,9,0.35,29,-3
395,Brendan Budy (LW),University of North Dakota,28,4,5,9,0.32,28,10
396,Jack Perbix (RW/D),University of Minnesota,30,4,5,9,0.30,8,11
397,Jacob Schmidt-Svejstrup (RW),University of Maine,11,3,6,9,0.82,10,-9
398,Logan Drevitch (LW),Merrimack College,12,3,6,9,0.75,12,1
399,Brandon Koch (D),Air Force Academy,14,3,6,9,0.64,6,-5
400,Matt Long (F),Canisius College,15,3,6,9,0.60,10,0
401,Zach Vinnell (D/LW),Merrimack College,16,3,6,9,0.56,6,0
402,Patrick Holway (D),Merrimack College,18,3,6,9,0.50,22,-3
403,Geoff Kitt (C),Mercyhurst University,19,3,6,9,0.47,4,3
404,Antonio Venuto (RW),Ferris State University,22,3,6,9,0.41,6,-5
405,McKade Webster (LW),University of Denver,22,3,6,9,0.41,16,-1
406,Phil Knies (LW/C),Miami University (Ohio),25,3,6,9,0.36,10,-9
407,Andy Carroll (D),Minnesota State University (Mankato),26,3,6,9,0.35,4,7
408,Kirby Proctor (D),University of Nebraska-Omaha,26,3,6,9,0.35,12,7
409,Will Hammer (F),St. Cloud State University,31,3,6,9,0.29,6,3
410,Ryan Miotto (F),Canisius College,15,2,7,9,0.60,8,10
411,Jared Brandt (D),Niagara University,18,2,7,9,0.50,10,-8
412,Nick Nardella (RW),Michigan Tech,22,2,7,9,0.41,10,4
413,Stepan Pokorny (F),Ferris State University,24,2,7,9,0.38,8,-4
414,Jesse Jacques (F),University of Minnesota-Duluth,28,2,7,9,0.32,18,4
415,Jack Jeffers (F),Lake Superior State University,28,2,7,9,0.32,23,2
416,Jacob Pivonka (C),University of Notre Dame,29,2,7,9,0.31,8,-2
417,Cullen Munson (C),University of Minnesota,31,2,7,9,0.29,12,8
418,Justin Wells (D),Bowling Green State University,31,2,7,9,0.29,18,22
419,Carter Berger (D),University of Connecticut,21,1,8,9,0.43,6,2
420,Joey Abate (LW/RW),University of Nebraska-Omaha,22,1,8,9,0.41,63,-4
421,Artem Shlaine (C),University of Connecticut,23,1,8,9,0.39,16,-2
422,Adam Karashik (D),University of Connecticut,23,1,8,9,0.39,27,-3
423,Tyler Inamoto (D),University of Wisconsin,26,1,8,9,0.35,15,7
424,Layton Ahac (D),Ohio State University,27,1,8,9,0.33,21,-7
425,Chris Lipe (D),Michigan Tech,29,1,8,9,0.31,4,8
426,Brendan Bushy (D),St. Cloud State University,31,1,8,9,0.29,27,7
427,Seamus Donohue (D),St. Cloud State University,31,1,8,9,0.29,40,14
428,Owen Norton (D),Mercyhurst University,19,0,9,9,0.47,8,-2
429,Wyatt Bongiovanni (C/LW),Quinnipiac University,9,5,3,8,0.89,12,2
430,J.D. Pogue (LW),Canisius College,13,5,3,8,0.62,6,6
431,Jake Pappalardo (C),College of the Holy Cross,13,5,3,8,0.62,12,-3
432,Aaron Grounds (F),American International College,18,5,3,8,0.44,10,8
433,Michael Kesselring (D),Northeastern University,20,5,3,8,0.40,23,-4
434,Michael Bevilacqua (D),Mercyhurst University,21,5,3,8,0.38,8,-2
435,Casey Carreau (C),Boston College,23,5,3,8,0.35,0,2
436,Jake Crespi (D),Michigan Tech,26,5,3,8,0.31,8,1
437,Wilmer Skoog (C),Boston University,14,4,4,8,0.57,2,-1
438,Ben Brar (LW),Merrimack College,15,4,4,8,0.53,10,0
439,Chase Gresock (F),Merrimack College,16,4,4,8,0.50,2,-8
440,John Beecher (C/LW),University of Michigan,16,4,4,8,0.50,4,4
441,Ben Poisson (F),University of Maine,16,4,4,8,0.50,19,-11
442,Nick Trela (F),St. Lawrence University,17,4,4,8,0.47,6,-7
443,Eric Cooley (RW/LW),Niagara University,21,4,4,8,0.38,18,-9
444,Uula Ruikka (D),Providence College,22,4,4,8,0.36,4,-5
445,Brett Van Os (LW),Western Michigan University,24,4,4,8,0.33,37,-4
446,Luke Grainger (RW/C),Western Michigan University,25,4,4,8,0.32,12,-5
447,Chase Brand (C),St. Cloud State University,27,4,4,8,0.30,21,7
448,Grant Silianoff (RW),University of Notre Dame,28,4,4,8,0.29,2,4
449,Will Gavin (LW/C),Air Force Academy,14,3,5,8,0.57,2,-6
450,Robert Mastrosimone (LW/C),Boston University,15,3,5,8,0.53,6,-1
451,Julius Janhonen (C),American International College,16,3,5,8,0.50,4,6
452,Alex Vlasic (D),Boston University,16,3,5,8,0.50,10,3
453,Maxwell Crozier (D),Providence College,17,3,5,8,0.47,10,5
454,Stanislav Demin (D),University of Denver,21,3,5,8,0.38,22,6
455,Paul Maust (LW),Mercyhurst University,21,3,5,8,0.38,28,3
456,Jeffrey Stewart (LW),Colgate University,22,3,5,8,0.36,6,-4
457,Arnaud Vachon (C),Colgate University,22,3,5,8,0.36,10,1
458,Connor McCarthy (D),Clarkson University,22,3,5,8,0.36,12,-2
459,Luke Reid (D),University of New Hampshire,22,3,5,8,0.36,12,-3
460,Kyler Kupka (F),St. Cloud State University,23,3,5,8,0.35,4,0
461,Jonny Tychonick (D),University of Nebraska-Omaha,23,3,5,8,0.35,16,-8
462,Jason O'Neill (F),Providence College,25,3,5,8,0.32,14,-2
463,Ryan Leibold (F),College of the Holy Cross,14,2,6,8,0.57,6,1
464,Domenick Fensore (D),Boston University,16,2,6,8,0.50,16,2
465,Tyler Spott (D),Northeastern University,18,2,6,8,0.44,2,4
466,Nick Anderson (D),Colgate University,21,2,6,8,0.38,10,6
467,Nicolas Müller (C/RW),Michigan State University,26,2,6,8,0.31,8,-6
468,Luke Morgan (LW),University of Michigan,26,2,6,8,0.31,17,6
469,Mathieu De St. Phalle (RW/LW),University of Wisconsin,31,2,6,8,0.26,4,1
470,Max Kaufman (F),Boston University,15,1,7,8,0.53,4,7
471,Josh McDougall (D),Mercyhurst University,17,1,7,8,0.47,0,1
472,Logan Gestro (D),Canisius College,17,1,7,8,0.47,12,10
473,Jacob Wilson (D),Arizona State University,22,1,7,8,0.36,12,4
474,Kohei Sato (LW),University of New Hampshire,22,1,7,8,0.36,33,0
475,Jaakko Heikkinen (F),University of Denver,24,1,7,8,0.33,6,3
476,Iivari Räsänen (D),Quinnipiac University,25,1,7,8,0.32,19,14
477,Jack Judson (D),Arizona State University,26,1,7,8,0.31,14,-4
478,Matt Hellickson (D),University of Notre Dame,29,1,7,8,0.28,10,2
479,Chris Harpur (D),Niagara University,15,0,8,8,0.53,38,-3
480,Jon McDonald (D),UMass-Lowell,17,0,8,8,0.47,4,-1
481,Ben Meehan (D),UMass-Lowell,17,0,8,8,0.47,27,-2
482,Tommy Parrottino (F),Michigan Tech,22,6,1,7,0.32,2,-4
483,Sam Stange (RW),University of Wisconsin,29,6,1,7,0.24,4,-4
484,Kale Howarth (LW/C),University of Connecticut,18,5,2,7,0.39,27,3
485,Tyler Kleven (D),University of North Dakota,22,5,2,7,0.32,37,11
486,Jonny Sorenson (F),University of Minnesota,28,5,2,7,0.25,2,4
487,Shawn Knowlton (F),Air Force Academy,10,4,3,7,0.70,19,-7
488,Brett Stapley (C),University of Denver,13,4,3,7,0.54,2,2
489,Christian Evers (D),University of Vermont,13,4,3,7,0.54,14,-8
490,Max Harper (F),Air Force Academy,14,4,3,7,0.50,0,-2
491,Ryan Tverberg (C/RW),University of Connecticut,14,4,3,7,0.50,16,1
492,Jami Virtanen (LW/RW),Canisius College,17,4,3,7,0.41,4,-1
493,Max Kouznetsov (LW/C),Canisius College,17,4,3,7,0.41,8,1
494,Marshall Moise (F),Ferris State University,21,4,3,7,0.33,16,-10
495,Michael Colella (F),Northern Michigan University,24,4,3,7,0.29,13,-15
496,Nolan Moyle (C/RW),University of Michigan,25,4,3,7,0.28,33,-1
497,Nathan Burke (C/LW),University of Minnesota,26,4,3,7,0.27,2,2
498,Kamil Sadlocha (C),Ohio State University,26,4,3,7,0.27,14,-9
499,Nate Clurman (D),University of Notre Dame,27,4,3,7,0.26,31,-1
500,Solag Bakich (F),University of Notre Dame,28,4,3,7,0.25,14,-3
501,Max Newton (C/RW),Merrimack College,9,3,4,7,0.78,4,0
502,Nolan Welsh (F),Long Island University,12,3,4,7,0.58,4,-1
503,Nathan Horn (F),Air Force Academy,14,3,4,7,0.50,2,-2
504,Thomas Daskas (F),Air Force Academy,14,3,4,7,0.50,12,-1
505,Logan Ferguson (RW),College of the Holy Cross,15,3,4,7,0.47,8,-1
506,Matthew Guerra (F),Robert Morris University,16,3,4,7,0.44,12,5
507,Lucas Herrmann (F),University of New Hampshire,17,3,4,7,0.41,4,-1
508,Austin Alger (F),Canisius College,17,3,4,7,0.41,6,3
509,Justin Kendall (F),Niagara University,19,3,4,7,0.37,6,4
510,Clayton Phillips (D),Penn State University,20,3,4,7,0.35,25,-7
511,Tyler Ward (LW),University of New Hampshire,21,3,4,7,0.33,6,-4
512,Jared Spooner (LW),Minnesota State University (Mankato),23,3,4,7,0.30,8,4
513,Robby Drazner (D),Miami University (Ohio),24,3,4,7,0.29,10,-6
514,Craig Needham (C),Providence College,25,3,4,7,0.28,2,2
515,Dominick Mersch (C),University of Wisconsin,27,3,4,7,0.26,14,4
516,Jared Cockrell (F),St. Cloud State University,30,3,4,7,0.23,12,7
517,Jacob Levin (D),Air Force Academy,12,2,5,7,0.58,6,-5
518,Eric Otto (F),American International College,15,2,5,7,0.47,8,0
519,Brandon Stanley (F),Niagara University,17,2,5,7,0.41,14,-6
520,Michal Stínil (LW/RW),American International College,17,2,5,7,0.41,31,-3
521,Sam Sternschein (LW),Penn State University,19,2,5,7,0.37,10,-13
522,Matt DeMelis (F),Northeastern University,21,2,5,7,0.33,6,-3
523,Christian Gorscak (F),Niagara University,21,2,5,7,0.33,8,-2
524,Evan Bell (D),Penn State University,22,2,5,7,0.32,16,4
525,Jayden Lee (D),Quinnipiac University,23,2,5,7,0.30,6,1
526,Nolan Schaeffer (D),Robert Morris University,24,2,5,7,0.29,12,-1
527,Jimmy Glynn (F),University of Nebraska-Omaha,25,2,5,7,0.28,2,-1
528,Joey Cipollone (C),Quinnipiac University,25,2,5,7,0.28,6,4
529,Jordan Sandhu (C),Arizona State University,26,2,5,7,0.27,6,-19
530,Eric Martin (F),Bemidji State University,27,2,5,7,0.26,10,-3
531,Wyatt Aamodt (D),Minnesota State University (Mankato),28,2,5,7,0.25,10,9
532,Jacob Bengtsson (D),Lake Superior State University,28,2,5,7,0.25,26,0
533,Ben Newhouse (D),Northern Michigan University,29,2,5,7,0.24,6,-12
534,Dustin Manz (C/RW),Lake Superior State University,29,2,5,7,0.24,10,4
535,Joshua Ess (D),University of Wisconsin,31,2,5,7,0.23,6,8
536,Zach Uens (D),Merrimack College,14,1,6,7,0.50,8,0
537,Luke Orysiuk (D),Bentley University,16,1,6,7,0.44,12,2
538,Dominic Dockery (D),Merrimack College,18,1,6,7,0.39,2,-11
539,Ryan Brushett (C),University of Nebraska-Omaha,18,1,6,7,0.39,4,3
540,Patrick Dawson (D),Sacred Heart University,18,1,6,7,0.39,10,-3
541,Jimmy Lambert (RW/C),University of Michigan,22,1,6,7,0.32,10,-3
542,Brett Thorne (D),Michigan Tech,30,1,6,7,0.23,29,6
543,Lucas Jaycox (D),St. Cloud State University,31,1,6,7,0.23,8,-1
544,Nicholas Zabaneh (C/LW),Boston University,16,0,7,7,0.44,4,0
545,Parker Revering (D),American International College,19,0,7,7,0.37,14,4
546,Matt Anderson (D),University of Minnesota-Duluth,28,0,7,7,0.25,16,7
547,Jesper Peltonen (D),University of Wisconsin,30,0,7,7,0.23,2,11
548,Anthony Kehrer (D),University of Wisconsin,31,0,7,7,0.23,12,11
549,Seth Fyten (F),Bowling Green State University,28,5,1,6,0.21,6,2
550,Steven Ipri (F),Mercyhurst University,11,4,2,6,0.55,12,-5
551,Zack Bross (F),Long Island University,11,4,2,6,0.55,31,-3
552,Noah Kane (C),Mercyhurst University,19,4,2,6,0.32,6,1
553,Zach Kaiser (C/LW),UMass-Lowell,20,4,2,6,0.30,2,-3
554,Matt Koopman (C/LW),Providence College,22,4,2,6,0.27,4,-5
555,Ethan Manderville (C),Colgate University,22,4,2,6,0.27,10,0
556,Justin Lee (D),University of Denver,24,4,2,6,0.25,6,-6
557,Nate Knoepke (D),University of Nebraska-Omaha,25,4,2,6,0.24,6,-4
558,Philip Lagunov (C),UMass,25,4,2,6,0.24,21,0
559,Mitch Meek (D),Long Island University,11,3,3,6,0.55,4,-7
560,Cameron Hebert (RW),Robert Morris University,15,3,3,6,0.40,6,4
561,Regan Kimens (LW),Merrimack College,16,3,3,6,0.38,2,-4
562,Dylan Peterson (C/RW),Boston University,16,3,3,6,0.38,25,2
563,Quinn Green (F),University of Alabama-Huntsville,19,3,3,6,0.32,12,-11
564,Jaedon Leslie (F),Ohio State University,21,3,3,6,0.29,6,-6
565,Tyr Thompson (C),University of Alabama-Huntsville,22,3,3,6,0.27,4,-5
566,Jacob Felker (F),Army (U.S. Military Academy),22,3,3,6,0.27,6,3
567,Luke Mobley (F),Clarkson University,22,3,3,6,0.27,8,4
568,Nick Bochen (D),Quinnipiac University,24,3,3,6,0.25,10,3
569,Ty Farmer (D),UMass,24,3,3,6,0.25,12,8
570,Chase Yoder (C/W),Providence College,25,3,3,6,0.24,8,1
571,Steven Agriogianis (RW),Northeastern University,11,2,4,6,0.55,0,5
572,Adrien Bisson (D),University of Maine,16,2,4,6,0.38,6,-6
573,Cameron Gendron (F),University of New Hampshire,16,2,4,6,0.38,6,2
574,David Melaragni (D),Canisius College,17,2,4,6,0.35,12,-2
575,Jake Willets (D),Ferris State University,17,2,4,6,0.35,14,-9
576,Dayne Finnson (D),University of Alabama-Huntsville,18,2,4,6,0.33,8,-10
577,Connor Sodergren (F),UMass-Lowell,18,2,4,6,0.33,12,3
578,Evan Tschumi (C/W),Colgate University,20,2,4,6,0.30,6,3
579,Lucas Bahn (D),University of Alabama-Huntsville,22,2,4,6,0.27,4,-17
580,Elliott McDermott (D),Colgate University,22,2,4,6,0.27,10,-8
581,Jack Millar (D),Colorado College,23,2,4,6,0.26,8,-14
582,C.J. Regula (D),Ohio State University,23,2,4,6,0.26,10,-12
583,Hunter McKown (C/RW),Colorado College,23,2,4,6,0.26,16,-7
584,Kyler Head (F),Robert Morris University,23,2,4,6,0.26,17,-1
585,Mason Nevers (C),University of Minnesota,25,2,4,6,0.24,4,7
586,Jerry Harding (F),UMass,25,2,4,6,0.24,10,2
587,Scooter Brickey (D),Western Michigan University,25,2,4,6,0.24,16,2
588,Raimonds Vitolins (C),University of Vermont,12,1,5,6,0.50,4,-3
589,Nicholas Cafarelli (F),University of New Hampshire,14,1,5,6,0.43,4,-4
590,Brett Callahan (D),American International College,15,1,5,6,0.40,2,1
591,Jack Summers (D),University of Michigan,15,1,5,6,0.40,14,6
592,Luke Edgerton (F),Niagara University,16,1,5,6,0.38,0,-5
593,Roman Kinal (D),University of Connecticut,16,1,5,6,0.38,0,6
594,Yan Kuznetsov (D),University of Connecticut,16,1,5,6,0.38,4,5
595,Regan Seiferling (D),RIT (Rochester Inst. of Tech.),16,1,5,6,0.38,12,-4
596,Ben Lown (C),Miami University (Ohio),17,1,5,6,0.35,2,-8
597,Jared Westcott (C/LW),Penn State University,17,1,5,6,0.35,4,-4
598,Grant Anderson (D),Sacred Heart University,18,1,5,6,0.33,4,-4
599,Jack St. Ivany (D),Boston College,18,1,5,6,0.33,6,-1
600,Nick Austin (D),Colgate University,18,1,5,6,0.33,8,-7
601,Steven Jandric (LW),University of Denver,20,1,5,6,0.30,6,6
602,Marko Reifenberger (C),Mercyhurst University,21,1,5,6,0.29,4,0
603,Matthew Berkovitz (D),Army (U.S. Military Academy),22,1,5,6,0.27,4,2
604,Noah Wilson (D),Army (U.S. Military Academy),22,1,5,6,0.27,19,5
605,Jake Flynn (D),University of Connecticut,23,1,5,6,0.26,12,-6
606,Tim Erkkila (D),Northern Michigan University,27,1,5,6,0.22,8,2
607,Jack McNeely (D),Minnesota State University (Mankato),27,1,5,6,0.22,8,12
608,Ryder Rolston (W/C),University of Notre Dame,28,1,5,6,0.21,31,4
609,Matt Staudacher (D),University of Minnesota,26,0,6,6,0.23,6,6
610,Ryan O'Connell (D),Ohio State University,27,0,6,6,0.22,10,-10
611,Matt Cairns (D),University of Minnesota-Duluth,28,0,6,6,0.21,12,17
612,Parker Saretsky (F),Michigan Tech,29,0,6,6,0.21,4,-2
613,Tristan Mullin (C/LW),University of Vermont,11,4,1,5,0.45,4,-11
614,Markus Boguslavsky (RW),Boston University,15,4,1,5,0.33,4,-1
615,Jagger Joshua (LW/RW),Michigan State University,26,4,1,5,0.19,41,-7
616,Carter Randklev (F),Niagara University,13,3,2,5,0.38,6,-4
617,Justin Paul (LW),St. Lawrence University,14,3,2,5,0.36,6,-5
618,Anthony Vincent (RW/C),College of the Holy Cross,14,3,2,5,0.36,29,-3
619,Rourke Russell (D),Miami University (Ohio),15,3,2,5,0.33,12,-2
620,Conor Lovett (F),Merrimack College,15,3,2,5,0.33,23,0
621,Anthony Baxter (D),UMass-Lowell,16,3,2,5,0.31,25,1
622,Brian Chambers (RW),UMass-Lowell,18,3,2,5,0.28,4,-6
623,Chase McLane (C/RW),Penn State University,19,3,2,5,0.26,4,-8
624,Garrett Van Wyhe (C),University of Michigan,21,3,2,5,0.24,10,-3
625,Paul McAvoy (F),Colgate University,22,3,2,5,0.23,2,0
626,Nick Campoli (C),Clarkson University,22,3,2,5,0.23,21,-3
627,Brian Rigali (F),University of Connecticut,23,3,2,5,0.22,16,-4
628,Connor Kelley (D),University of Minnesota-Duluth,25,3,2,5,0.20,4,10
629,Colby Enns (D),Northern Michigan University,26,3,2,5,0.19,23,3
630,Austin Pooley (C),Ohio State University,27,3,2,5,0.19,6,-6
631,Luke Loheit (RW),University of Minnesota-Duluth,28,3,2,5,0.18,35,5
632,Christian Rajic (C),Long Island University,10,2,3,5,0.50,24,-5
633,Jacques Bouquot (C/LW),University of Vermont,12,2,3,5,0.42,2,2
634,Ryan Savage (RW),Miami University (Ohio),14,2,3,5,0.36,6,-1
635,Blake Bride (RW),Air Force Academy,14,2,3,5,0.36,12,-5
636,Josh Dunne (C/LW),Clarkson University,14,2,3,5,0.36,26,1
637,J.D. Greenway (F/D),University of Maine,14,2,3,5,0.36,28,-13
638,Nico Somerville (D),American International College,16,2,3,5,0.31,6,4
639,Tyler Jeanson (C),Colgate University,17,2,3,5,0.29,4,-2
640,Brett Abdelnour (LW),Army (U.S. Military Academy),17,2,3,5,0.29,4,-4
641,Oliver MacDonald (F),UMass,17,2,3,5,0.29,8,4
642,Josef Mysak (D),Niagara University,17,2,3,5,0.29,12,4
643,Cooper Moore (D),University of North Dakota,18,2,3,5,0.28,8,-7
644,Harrison Rees (D),University of Connecticut,21,2,3,5,0.24,8,7
645,Cade Townend (D),Mercyhurst University,21,2,3,5,0.24,14,-9
646,Troy Conzo (F),Colorado College,22,2,3,5,0.23,6,-7
647,Drew Lennon (D),University of Alabama-Huntsville,22,2,3,5,0.23,8,-19
648,Collin Peters (F),Ohio State University,22,2,3,5,0.23,63,-6
649,Monte Graham (F),Miami University (Ohio),23,2,3,5,0.22,14,-13
650,Blake Biondi (C/RW),University of Minnesota-Duluth,26,2,3,5,0.19,8,4
651,Alex Adams (F),Bemidji State University,26,2,3,5,0.19,12,0
652,Logan Britt (D),Quinnipiac University,27,2,3,5,0.19,14,13
653,Anthony Del Gaizo (LW/C),UMass,28,2,3,5,0.18,16,4
654,Max Balinson (D),Long Island University,11,1,4,5,0.45,8,-7
655,Cooper Haar (LW),Canisius College,13,1,4,5,0.38,6,3
656,Vladislav Dzhioshvili (C),University of Vermont,13,1,4,5,0.38,18,2
657,Tim Makowski (D),St. Lawrence University,17,1,4,5,0.29,6,-6
658,Philip Alftberg (D),St. Lawrence University,17,1,4,5,0.29,12,1
659,Eric Faith (LW),UMass,18,1,4,5,0.28,2,5
660,Nick Capone (RW),University of Connecticut,20,1,4,5,0.25,8,4
661,Patrick Cozzi (RW),Colorado College,22,1,4,5,0.23,2,-2
662,Gavin Gulash (F),Robert Morris University,22,1,4,5,0.23,12,6
663,P.J. Marrocco (F),Arizona State University,24,1,4,5,0.21,0,-13
664,Cam McDonald (D),Providence College,24,1,4,5,0.21,8,1
665,Ethan Scardina (C),Bowling Green State University,24,1,4,5,0.21,8,4
666,Liam MacDougall (C/W),Ferris State University,24,1,4,5,0.21,18,-13
667,Jacob Truscott (D),University of Michigan,26,1,4,5,0.19,8,6
668,Kyle Haskins (C),Michigan State University,27,1,4,5,0.19,10,-3
669,Hunter Lellig (D),University of Minnesota-Duluth,28,1,4,5,0.18,4,10
670,Kyle Looft (D),Bemidji State University,29,1,4,5,0.17,10,10
671,Bennett Norlin (F),Air Force Academy,13,0,5,5,0.38,0,6
672,A.J. Villella (D),Bentley University,15,0,5,5,0.33,0,5
673,Matt Tugnutt (LW/C),Providence College,16,0,5,5,0.31,8,-1
674,Patrick Kramer (C),Merrimack College,17,0,5,5,0.29,10,-9
675,Spencer Berry (D),RIT (Rochester Inst. of Tech.),18,0,5,5,0.28,15,9
676,Bryson Traptow (F),RIT (Rochester Inst. of Tech.),20,0,5,5,0.25,28,0
677,Julian Kislin (D),Northeastern University,21,0,5,5,0.24,10,-9
678,Will MacKinnon (D),University of New Hampshire,22,0,5,5,0.23,20,1
679,Robbie Stucker (D),University of Minnesota,23,0,5,5,0.22,2,1
680,Ben Schultheis (D),Ferris State University,25,0,5,5,0.20,12,-6
681,Keaton Pehrson (D),University of Michigan,26,0,5,5,0.19,23,2
682,Ben Brinkman (D),University of Minnesota,29,0,5,5,0.17,18,13
683,Gustav Müller (C/LW),Long Island University,12,3,1,4,0.33,4,-1
684,Jordan Di Cicco (D),Long Island University,13,3,1,4,0.31,6,-4
685,Kevin Obssuth (LW),Canisius College,16,3,1,4,0.25,19,-4
686,George Mika (F),UMass,17,3,1,4,0.24,0,1
687,Trevor Cosgrove (D),Colgate University,22,3,1,4,0.18,10,-4
688,Logan Will (F),Colorado College,23,3,1,4,0.17,12,-6
689,John Sladic (F),Miami University (Ohio),25,3,1,4,0.16,17,-11
690,Justin Young (C),American International College,6,2,2,4,0.67,6,3
691,Nick Cardelli (C/RW),Bemidji State University,7,2,2,4,0.57,0,3
692,Brendan Schneider (C),Mercyhurst University,9,2,2,4,0.44,5,0
693,Joe Cassetti (C/LW),Miami University (Ohio),11,2,2,4,0.36,6,-1
694,Luke Mylymok (W/C),University of Minnesota-Duluth,12,2,2,4,0.33,15,5
695,A.J. Drobot (RW),University of Maine,16,2,2,4,0.25,2,-1
696,Andrew Dumaresque (C),College of the Holy Cross,16,2,2,4,0.25,10,-15
697,Cody Laskosky (C),RIT (Rochester Inst. of Tech.),18,2,2,4,0.22,8,-7
698,Sean Dhooghe (RW),Arizona State University,20,2,2,4,0.20,2,-17
699,Benton Maass (D),University of New Hampshire,20,2,2,4,0.20,4,-9
700,Brett Edwards (F),University of Denver,20,2,2,4,0.20,12,-9
701,Adrian Danchenko (F),University of Alabama-Huntsville,20,2,2,4,0.20,37,-6
702,Mitchell Mattson (C),Michigan State University,21,2,2,4,0.19,2,-3
703,Mason Snell (D),Penn State University,21,2,2,4,0.19,20,-7
704,Jarrod Gourley (D),Arizona State University,22,2,2,4,0.18,10,-3
705,Jake Durflinger (RW/C),University of Denver,22,2,2,4,0.18,14,-4
706,Mike Vorlicky (D),University of Wisconsin,24,2,2,4,0.17,16,-4
707,Connor Caponi (F),University of Denver,24,2,2,4,0.17,25,-4
708,Brody Stevens (C),Michigan State University,27,2,2,4,0.15,18,-15
709,Jordan Schulting (D),UMass-Lowell,6,1,3,4,0.67,4,4
710,Rylee St. Onge (LW),Mercyhurst University,9,1,3,4,0.44,0,-3
711,Bo Hanson (D),University of Denver,12,1,3,4,0.33,4,2
712,Blake Wells (F),UMass-Lowell,12,1,3,4,0.33,4,-1
713,Todd Goehring (F),Sacred Heart University,12,1,3,4,0.33,4,-1
714,Brian Adams (F),Air Force Academy,12,1,3,4,0.33,8,2
715,Joey Molenaar (F),St. Cloud State University,13,1,3,4,0.31,2,1
716,Jack Quinn (F),Long Island University,13,1,3,4,0.31,2,0
717,Mick Heneghan (D),University of Alabama-Huntsville,13,1,3,4,0.31,8,-4
718,Josh Allan (D),Sacred Heart University,13,1,3,4,0.31,11,-7
719,Andrew Lucas (D),University of Vermont,13,1,3,4,0.31,12,-2
720,David Lafrance (D),Robert Morris University,14,1,3,4,0.29,0,1
721,Jackson Decker (D),Canisius College,14,1,3,4,0.29,4,14
722,Zac Herrmann (D),Niagara University,14,1,3,4,0.29,6,1
723,John McDermott (LW),Providence College,15,1,3,4,0.27,2,3
724,Dakota Raabe (LW),University of Michigan,15,1,3,4,0.27,2,2
725,Reilly Moran (F),St. Lawrence University,16,1,3,4,0.25,4,1
726,Jason Brancheau (F),Ferris State University,16,1,3,4,0.25,4,-8
727,Blais Richartz (F),Michigan Tech,17,1,3,4,0.24,2,3
728,Devon Daniels (D),Mercyhurst University,18,1,3,4,0.22,0,1
729,Louis Jamernik (RW),University of North Dakota,19,1,3,4,0.21,10,6
730,Ben Allen (LW),University of Alabama-Huntsville,20,1,3,4,0.20,2,-9
731,Levi Glasman (LW),Colgate University,20,1,3,4,0.20,8,-2
732,Jack Olmstead (C/LW/RW),Miami University (Ohio),20,1,3,4,0.20,12,-8
733,Chrystopher Collin (C/LW),Bowling Green State University,21,1,3,4,0.19,2,3
734,Gabe Bast (D),University of North Dakota,21,1,3,4,0.19,29,7
735,Colton Young (LW),Colgate University,21,1,3,4,0.19,38,-6
736,Jordan Power (D),Clarkson University,22,1,3,4,0.18,8,4
737,Zach Berzolla (D),Colorado College,23,1,3,4,0.17,59,-9
738,Davis Bunz (D),Providence College,25,1,3,4,0.16,8,-2
739,Adam Goodsir (F),Michigan State University,25,1,3,4,0.16,10,-2
740,Tanner Hickey (D),Arizona State University,26,1,3,4,0.15,8,-23
741,Pierce Crawford (F),University of Notre Dame,27,1,3,4,0.15,2,0
742,Tommy Miller (D),Michigan State University,27,1,3,4,0.15,4,-11
743,Chase Gamelin (F),Lake Superior State University,29,1,3,4,0.14,0,2
744,Garrett Daly (D),Bowling Green State University,29,1,3,4,0.14,6,0
745,Alex Ambrosio (F),Lake Superior State University,29,1,3,4,0.14,14,0
746,Jonny Mulera (F),University of Maine,9,0,4,4,0.44,4,-1
747,Ondřej Pavel (C/LW),Minnesota State University (Mankato),11,0,4,4,0.36,8,4
748,Charlie Kelleher (RW),University of New Hampshire,13,0,4,4,0.31,10,-3
749,Derek Hamelin (D),Canisius College,15,0,4,4,0.27,4,0
750,Jeff Baum (D),American International College,16,0,4,4,0.25,6,7
751,Blake Wareham (D),Canisius College,17,0,4,4,0.24,0,3
752,Jake Stella (LW),American International College,17,0,4,4,0.24,2,1
753,Harrison Blaisdell (C),University of North Dakota,19,0,4,4,0.21,10,6
754,Kyle Mayhew (D),University of Denver,20,0,4,4,0.20,17,-2
755,Nolan Krenzen (D),University of Nebraska-Omaha,21,0,4,4,0.19,14,-4
756,John Keranen (F),Army (U.S. Military Academy),22,0,4,4,0.18,17,-1
757,Tyler Love (D),Robert Morris University,24,0,4,4,0.17,4,7
758,Kristóf Papp (C),Michigan State University,25,0,4,4,0.16,0,-4
759,Nash Nienhuis (D),Michigan State University,25,0,4,4,0.16,2,-9
760,Ryan Sullivan (F),UMass,25,0,4,4,0.16,4,1
761,Logan Pietila (RW/C),Michigan Tech,28,0,4,4,0.14,2,-3
762,Tyler Jubenvill (D),Bemidji State University,29,0,4,4,0.14,6,11
763,Connor Marritt (F),Northern Michigan University,29,0,4,4,0.14,8,-10
764,Brad Morrissey (RW),University of Maine,8,3,0,3,0.38,8,-3
765,Reid Irwin (D/C),University of Denver,12,3,0,3,0.25,6,2
766,Andrew Petrucci (C),RIT (Rochester Inst. of Tech.),19,3,0,3,0.16,10,-1
767,Jason Pineo (C),Niagara University,21,3,0,3,0.14,8,-4
768,Jamie Engelbert (C),Providence College,23,3,0,3,0.13,23,1
769,T.J. Friedmann (W/C),Quinnipiac University,25,3,0,3,0.12,35,0
770,Garrett Klee (F),Northern Michigan University,26,3,0,3,0.12,10,-10
771,Blake Bennett (LW/RW),American International College,5,2,1,3,0.60,2,1
772,Tucker McIntosh (D),St. Lawrence University,6,2,1,3,0.50,6,0
773,Brad Belisle (C),Bemidji State University,9,2,1,3,0.33,2,0
774,Justin Cmunt (LW),Mercyhurst University,11,2,1,3,0.27,8,0
775,Reed Lebster (RW),UMass,12,2,1,3,0.25,2,-1
776,Ryan Nicholson (D),RIT (Rochester Inst. of Tech.),12,2,1,3,0.25,6,-7
777,Bobby Hampton (C),Penn State University,13,2,1,3,0.23,0,-6
778,Michael Kane (F),College of the Holy Cross,13,2,1,3,0.23,6,-2
779,Tristan Poissant (F),University of Maine,14,2,1,3,0.21,2,-7
780,Ty Pochipinski (F),Air Force Academy,14,2,1,3,0.21,6,-8
781,Luka Maver (C),American International College,14,2,1,3,0.21,17,6
782,Bobby Young (C),College of the Holy Cross,15,2,1,3,0.20,2,-4
783,Matt Quercia (C/LW),Boston University,16,2,1,3,0.19,4,-5
784,Dylan Pitera (F),Bentley University,16,2,1,3,0.19,6,-3
785,Ashton Fry (F),St. Lawrence University,16,2,1,3,0.19,14,-1
786,Jack Robilotti (D),College of the Holy Cross,16,2,1,3,0.19,20,1
787,Jordan Steinmetz (F),St. Lawrence University,17,2,1,3,0.18,8,-10
788,Bray Crowder (D),Miami University (Ohio),17,2,1,3,0.18,10,-11
789,Ricky Lyle (LW),Army (U.S. Military Academy),18,2,1,3,0.17,12,3
790,Carson Bantle (LW/RW),Michigan Tech,19,2,1,3,0.16,22,-3
791,Logan Ganie (LW),Michigan Tech,20,2,1,3,0.15,8,-3
792,Chase Pletzke (C),Miami University (Ohio),21,2,1,3,0.14,2,-10
793,John Laurito (F),Army (U.S. Military Academy),21,2,1,3,0.14,14,-2
794,Roman Kraemer (F),Robert Morris University,22,2,1,3,0.14,6,-2
795,Ryder Donovan (C/RW),University of Wisconsin,22,2,1,3,0.14,40,-1
796,Gianluca Esteves (F),Michigan State University,23,2,1,3,0.13,4,-5
797,Brian Hawkinson (RW),Colorado College,23,2,1,3,0.13,4,-7
798,Harrison Roy (F),Boston College,23,2,1,3,0.13,19,-2
799,Jason Dhooghe (F),University of Wisconsin,24,2,1,3,0.13,2,3
800,Hampus Rydqvist (D),Miami University (Ohio),24,2,1,3,0.13,10,-4
801,Jamie Rome (F),Western Michigan University,24,2,1,3,0.13,12,-6
802,Jackson Keane (C),University of North Dakota,25,2,1,3,0.12,6,-1
803,Jack Clement (D),Miami University (Ohio),25,2,1,3,0.12,6,-21
804,Cole Krygier (D),Michigan State University,25,2,1,3,0.12,25,-5
805,Jack DeBoer (C),Boston University,7,1,2,3,0.43,0,3
806,Tony Malinowski (D),Minnesota State University (Mankato),10,1,2,3,0.30,2,5
807,Emil Öhrvall (LW),Sacred Heart University,10,1,2,3,0.30,8,-5
808,Cassidy Bowes (LW),University of Connecticut,11,1,2,3,0.27,6,2
809,Nick Wicks (F),Clarkson University,12,1,2,3,0.25,0,-1
810,Carl Fish (D),University of Minnesota,12,1,2,3,0.25,2,8
811,Dylan Woolf (D),St. Lawrence University,12,1,2,3,0.25,16,1
812,Bryce Misley (C),University of Vermont,13,1,2,3,0.23,0,-10
813,Logan Milliken (D),College of the Holy Cross,13,1,2,3,0.23,2,1
814,Dallas Tulik (F),Ferris State University,13,1,2,3,0.23,4,-4
815,Dante Spagnuolo (C),Mercyhurst University,13,1,2,3,0.23,10,-7
816,Alex Esposito (RW),University of Vermont,13,1,2,3,0.23,10,-6
817,Keanan Stewart (F),Mercyhurst University,13,1,2,3,0.23,17,1
818,Jay Keranen (D),University of Michigan,14,1,2,3,0.21,0,0
819,Cam Burke (C),University of Notre Dame,14,1,2,3,0.21,2,-2
820,Joe O'Connor (D),Quinnipiac University,14,1,2,3,0.21,17,1
821,Connor Merkley (C),University of Alabama-Huntsville,14,1,2,3,0.21,25,-9
822,Nolan Sawchuk (D),UMass-Lowell,15,1,2,3,0.20,8,-2
823,Jamie Armstrong (LW/RW),Boston University,16,1,2,3,0.19,6,1
824,Jamie Collins (F),Clarkson University,16,1,2,3,0.19,6,-6
825,Jan Kern (LW),American International College,16,1,2,3,0.19,10,3
826,Shane McMahan (LW),Minnesota State University (Mankato),16,1,2,3,0.19,12,2
827,Nick Boyagian (F),Sacred Heart University,17,1,2,3,0.18,4,-2
828,Jackson Jutting (F),Colorado College,19,1,2,3,0.16,4,-8
829,Diarmad DiMurro (D),RIT (Rochester Inst. of Tech.),19,1,2,3,0.16,4,-4
830,Matthew Cassidy (RW),Ohio State University,19,1,2,3,0.16,20,-5
831,Drew Cooper (D),Ferris State University,20,1,2,3,0.15,0,-20
832,Brian Hurley (D),Clarkson University,20,1,2,3,0.15,2,6
833,Scott Corbett (C),Miami University (Ohio),20,1,2,3,0.15,12,-9
834,Anton Malmström (D),Bowling Green State University,20,1,2,3,0.15,17,3
835,Ross Mitton (RW/LW),Colgate University,21,1,2,3,0.14,4,-3
836,Brian Scoville (D),University of Alabama-Huntsville,22,1,2,3,0.14,22,-12
837,Nicklas Andrews (D),Colorado College,22,1,2,3,0.14,22,-4
838,Michael Underwood (D),Clarkson University,22,1,2,3,0.14,26,5
839,Michael Karow (D),Boston College,24,1,2,3,0.13,18,10
840,Christian Krygier (D),Michigan State University,26,1,2,3,0.12,54,-4
841,Darby Gula (D),Bemidji State University,28,1,2,3,0.11,2,4
842,Marcus Chorney (D),Quinnipiac University,28,1,2,3,0.11,32,4
843,Sam Rossini (D),University of Minnesota,5,0,3,3,0.60,0,5
844,Matt Allen (F),UMass-Lowell,5,0,3,3,0.60,0,1
845,Sam Colangelo (RW/C),Northeastern University,8,0,3,3,0.38,2,-3
846,Dalton Hunter (RW/LW),Mercyhurst University,8,0,3,3,0.38,2,-1
847,Hunter Johannes (LW),American International College,8,0,3,3,0.38,6,5
848,Jake Harrison (D),University of Nebraska-Omaha,10,0,3,3,0.30,2,4
849,Conner Jean (C),College of the Holy Cross,10,0,3,3,0.30,4,-2
850,Veli-Matti Tiuraniemi (D),University of Maine,14,0,3,3,0.21,6,1
851,Luke Robinson (D),Air Force Academy,14,0,3,3,0.21,8,1
852,Marshall Bowery (F),Air Force Academy,14,0,3,3,0.21,12,-12
853,T.J. Walsh (LW),Northeastern University,15,0,3,3,0.20,2,-1
854,Chase Foley (D),Colorado College,15,0,3,3,0.20,2,-2
855,Will Zmolek (D),Bemidji State University,15,0,3,3,0.20,2,4
856,Geoff Lawson (D),Robert Morris University,15,0,3,3,0.20,4,-3
857,Cédric Fiedler (D),Western Michigan University,15,0,3,3,0.20,6,0
858,Hank Sorensen (D),Northern Michigan University,15,0,3,3,0.20,53,-1
859,Quinn Wichers (D),Mercyhurst University,17,0,3,3,0.18,4,1
860,Alex Stevens (D),Penn State University,17,0,3,3,0.18,6,0
861,David Silye (C/RW),Clarkson University,17,0,3,3,0.18,6,-6
862,Lincoln Erne (D),Canisius College,17,0,3,3,0.18,8,5
863,Dimitri Mikrogiannakis (D),RIT (Rochester Inst. of Tech.),18,0,3,3,0.17,8,-2
864,Dustyn McFaul (D),Clarkson University,19,0,3,3,0.16,19,6
865,Conor Witherspoon (F),University of Alabama-Huntsville,21,0,3,3,0.14,10,-16
866,Evan McIntyre (D),Ohio State University,21,0,3,3,0.14,19,-8
867,Connor Fedorek (D),Ferris State University,24,0,3,3,0.13,8,-8
868,Louie Roehl (D),University of Minnesota-Duluth,28,0,3,3,0.11,34,2
869,Simon Boyko (RW),University of Vermont,7,2,0,2,0.29,0,-3
870,Levi Kleiboer (D),University of Maine,7,2,0,2,0.29,2,-9
871,Matthew Steeves (F),University of Notre Dame,12,2,0,2,0.17,2,-2
872,Jacob Franczak (C),Long Island University,12,2,0,2,0.17,4,-7
873,Brady Gaudette (F),University of Maine,13,2,0,2,0.15,6,-6
874,Alec Capstick (D),Miami University (Ohio),15,2,0,2,0.13,4,-3
875,Bennett Stockdale (RW),University of Alabama-Huntsville,15,2,0,2,0.13,6,-6
876,Darcy Walsh (C),Robert Morris University,15,2,0,2,0.13,19,2
877,Ryan Wheeler (D/F),University of Connecticut,18,2,0,2,0.11,8,0
878,Dom Garcia (F),Arizona State University,24,2,0,2,0.08,0,-5
879,Patrick Guzzo (C),Ohio State University,26,2,0,2,0.08,4,-7
880,Ty Amonte (RW),Boston University,2,1,1,2,1.00,2,0
881,Matt Cameron (F),Niagara University,4,1,1,2,0.50,0,1
882,Joe Winkelmann (C),Bentley University,4,1,1,2,0.50,0,0
883,Jack Ricketts (C),College of the Holy Cross,5,1,1,2,0.40,2,-1
884,Jake Wise (C/LW),Boston University,5,1,1,2,0.40,4,-2
885,Niclas Puikkonen (W/C),Canisius College,6,1,1,2,0.33,0,3
886,Matt Clark (D),Bentley University,6,1,1,2,0.33,6,-2
887,Preston Brodziak (F),Long Island University,8,1,1,2,0.25,4,-2
888,Jordan Kaplan (RW/C),University of Vermont,9,1,1,2,0.22,4,-4
889,Chad Hillebrand (LW/C),Western Michigan University,12,1,1,2,0.17,4,-4
890,Dovar Tinling (C),University of Vermont,12,1,1,2,0.17,4,-4
891,Case McCarthy (D),Boston University,12,1,1,2,0.17,8,1
892,Charlie Marchand (D),Bentley University,12,1,1,2,0.17,21,-4
893,Joe Hankinson (F),University of New Hampshire,13,1,1,2,0.15,4,-1
894,Carter Long (D),University of Vermont,13,1,1,2,0.15,4,-3
895,Ryland Mosley (LW/RW),Michigan Tech,13,1,1,2,0.15,6,-1
896,Mac Welsher (C),Merrimack College,13,1,1,2,0.15,6,-7
897,Xander Lamppa (F),Penn State University,13,1,1,2,0.15,10,-4
898,Zachary Mirageas (D),Air Force Academy,13,1,1,2,0.15,38,-8
899,Jérémie Bucheler (D),Northeastern University,14,1,1,2,0.14,4,4
900,Philippe Lapointe (F),University of Michigan,14,1,1,2,0.14,8,-3
901,Jack Quinlivan (F),University of Maine,14,1,1,2,0.14,8,-6
902,Frank Boie (D),College of the Holy Cross,15,1,1,2,0.13,4,-3
903,Cole Kodsi (LW),Bentley University,16,1,1,2,0.13,4,-3
904,Matt Slick (D),College of the Holy Cross,16,1,1,2,0.13,6,-4
905,Max Finner (D),Ferris State University,16,1,1,2,0.13,8,-2
906,Josh Rieger (D),University of North Dakota,16,1,1,2,0.13,15,3
907,Nik Armstrong-Kingcade (F),UMass-Lowell,18,1,1,2,0.11,4,0
908,Jacob Dirks (F),Ferris State University,18,1,1,2,0.11,4,-7
909,Brady Ziemer (D),St. Cloud State University,18,1,1,2,0.11,8,0
910,Bryan Yoon (D),Colorado College,19,1,1,2,0.11,2,-10
911,Danny Weight (C),Boston College,19,1,1,2,0.11,2,-1
912,Hugh Larkin (RW),Western Michigan University,19,1,1,2,0.11,7,1
913,Luke Farthing (D),Ferris State University,20,1,1,2,0.10,6,-2
914,Noah Beck (D),Clarkson University,20,1,1,2,0.10,8,-2
915,Connor Mayer (D),Colorado College,22,1,1,2,0.09,21,-5
916,Ty Readman (C),Northern Michigan University,23,1,1,2,0.09,4,-8
917,Samuel Solenský (C/RW),Bemidji State University,28,1,1,2,0.07,4,-2
918,Tyrell Buckley (D),Michigan Tech,29,1,1,2,0.07,12,-2
919,Hudson Lambert (D),Canisius College,4,0,2,2,0.50,0,1
920,Keenan Lund (F),Air Force Academy,4,0,2,2,0.50,0,2
921,Tanner Vescio (D),Northern Michigan University,5,0,2,2,0.40,2,0
922,Bradley Stonnell (D),Robert Morris University,6,0,2,2,0.33,0,4
923,Sam Skinner (D),Ferris State University,6,0,2,2,0.33,2,-2
924,Kabore Dunn (D),University of Maine,7,0,2,2,0.29,4,-3
925,Jake Rosenbaum (D),University of Minnesota-Duluth,8,0,2,2,0.25,0,4
926,John DeRoche (D/F),Northeastern University,10,0,2,2,0.20,0,-5
927,Mack Byers (LW),Northern Michigan University,10,0,2,2,0.20,2,-3
928,Arseni Smekhnov (C),Long Island University,10,0,2,2,0.20,4,0
929,Dawson Bruneski (D),University of Maine,10,0,2,2,0.20,6,-3
930,Garrett Clegg (RW),Robert Morris University,10,0,2,2,0.20,19,0
931,Cade Kowalski (C/RW),Ferris State University,10,0,2,2,0.20,21,-1
932,Sam Stevens (C/LW),Boston University,11,0,2,2,0.18,2,2
933,Will Schlagenhauf (F),Bentley University,11,0,2,2,0.18,10,-1
934,Brett Humberstone (D),Long Island University,11,0,2,2,0.18,19,-6
935,Christopher Konin (F),Army (U.S. Military Academy),13,0,2,2,0.15,0,0
936,Jesse Pomeroy (D),Niagara University,13,0,2,2,0.15,4,-11
937,Mathew Harris (D),Long Island University,13,0,2,2,0.15,6,-1
938,Ryan Nolan (F),Merrimack College,13,0,2,2,0.15,8,-5
939,Mick Messner (LW),Merrimack College,14,0,2,2,0.14,2,-10
940,Jeppe Urup Mogensen (D),Sacred Heart University,14,0,2,2,0.14,4,-10
941,Grayson Constable (F),College of the Holy Cross,14,0,2,2,0.14,6,-2
942,Jack Doremus (C/W),University of Denver,14,0,2,2,0.14,6,-6
943,Cade Webber (D),Boston University,14,0,2,2,0.14,15,9
944,Jarred White (C),Western Michigan University,14,0,2,2,0.14,22,-3
945,Nick Hale (D),College of the Holy Cross,15,0,2,2,0.13,4,-8
946,Andrew Sinard (D),Miami University (Ohio),15,0,2,2,0.13,8,0
947,Noah Ganske (D),Northern Michigan University,15,0,2,2,0.13,14,-5
948,Jeremy Gervais (D),Lake Superior State University,16,0,2,2,0.13,0,9
949,Evan Wisocky (C),Sacred Heart University,16,0,2,2,0.13,0,2
950,Marco Bozzo (C),Northeastern University,16,0,2,2,0.13,2,0
951,Aleksi Peltonen (F),St. Lawrence University,16,0,2,2,0.13,2,-5
952,Thomas Jarman (D),Boston University,16,0,2,2,0.13,10,1
953,Jake Stevens (D),St. Lawrence University,16,0,2,2,0.13,12,-8
954,Donavan Houle (C/RW),University of Maine,16,0,2,2,0.13,14,-3
955,Simon Butala (D),University of Maine,16,0,2,2,0.13,35,-8
956,Alex Bates (D),Sacred Heart University,17,0,2,2,0.12,14,-3
957,Jordan Biro (C),Colorado College,18,0,2,2,0.11,2,-6
958,Tim Lovell (D),Boston College,18,0,2,2,0.11,6,3
959,Griffin Ness (F),University of North Dakota,18,0,2,2,0.11,12,-4
960,Aiden Hansen-Bukata (D),RIT (Rochester Inst. of Tech.),20,0,2,2,0.10,2,2
961,Michael Gildon (C/LW),Ohio State University,20,0,2,2,0.10,6,-3
962,Nikolai Jenson (D),University of New Hampshire,20,0,2,2,0.10,12,-1
963,Daniel Hilsendager (D),Western Michigan University,21,0,2,2,0.10,4,-4
964,A.J. Hodges (LW),Michigan State University,22,0,2,2,0.09,0,-8
965,Hugo Blixt (D),Colorado College,22,0,2,2,0.09,37,-5
966,Connor Wood (RW),University of Alabama-Huntsville,22,0,2,2,0.09,60,-19
967,Zac Robbins (F),University of Connecticut,23,0,2,2,0.09,2,-1
968,Griffin Mendel (D),University of Denver,24,0,2,2,0.08,12,-7
969,Aiden Gallacher (D),Michigan State University,26,0,2,2,0.08,23,-7
970,Gvido Jansons (D),Arizona State University,26,0,2,2,0.08,34,-20
971,Darwin Lakoduk (F),American International College,1,1,0,1,1.00,0,1
972,McKay Flanagan (D),Colorado College,2,1,0,1,0.50,0,1
973,Chase Danol (F),Bowling Green State University,3,1,0,1,0.33,0,0
974,Sean Driscoll (D),Boston University,4,1,0,1,0.25,2,1
975,Sam Miller (D),American International College,4,1,0,1,0.25,2,1
976,Charlie Campbell (F),Clarkson University,6,1,0,1,0.17,0,-1
977,Kyle Jeffers (C/RW),American International College,6,1,0,1,0.17,2,-3
978,Matthew Gleason (C),Colorado College,7,1,0,1,0.14,4,-2
979,Edward Lindelöw (C),University of Maine,8,1,0,1,0.13,2,-2
980,Will Garin (RW),Bentley University,9,1,0,1,0.11,6,-4
981,Jack Lyons (D),Canisius College,10,1,0,1,0.10,0,1
982,Ben Almquist (F),University of Minnesota-Duluth,10,1,0,1,0.10,0,1
983,Jacob Marti (F),Air Force Academy,11,1,0,1,0.09,18,-4
984,Aaron Myers (F),Bemidji State University,12,1,0,1,0.08,0,-1
985,Jett Jungels (F),Northern Michigan University,12,1,0,1,0.08,2,-1
986,Albin Nilsson (C),Providence College,12,1,0,1,0.08,4,2
987,Brenden MacLaren (F),Ferris State University,12,1,0,1,0.08,10,-5
988,Tim Washe (C/LW),Western Michigan University,13,1,0,1,0.08,10,-3
989,Eric Linell (C/RW),University of Connecticut,14,1,0,1,0.07,0,0
990,Michael Holland (F),Miami University (Ohio),14,1,0,1,0.07,0,-3
991,Tim Clifton (C),Sacred Heart University,14,1,0,1,0.07,21,-3
992,Liam Dennison (D),Merrimack College,15,1,0,1,0.07,4,-13
993,Austen Long (RW/C),American International College,15,1,0,1,0.07,4,-1
994,Dylan Moulton (D),Miami University (Ohio),15,1,0,1,0.07,6,-3
995,Neil Shea (LW),Northeastern University,16,1,0,1,0.06,2,-4
996,Alec Cicero (F),College of the Holy Cross,16,1,0,1,0.06,4,-7
997,Tyler Gratton (RW),Penn State University,17,1,0,1,0.06,8,-8
998,Joseph Dunlap (RW/C),Ohio State University,17,1,0,1,0.06,16,-8
999,Noah Finstrom (F),University of Alabama-Huntsville,18,1,0,1,0.06,2,-8
1000,Frank Vitucci (F),University of Alabama-Huntsville,19,1,0,1,0.05,6,-13
1001,Rylan Van Unen (F),Northern Michigan University,19,1,0,1,0.05,8,-2
1002,C.J. McGee (D),Quinnipiac University,19,1,0,1,0.05,12,-2
1003,Zachary Plucinski (D),University of Notre Dame,20,1,0,1,0.05,10,0
1004,Dominick Procopio (D),UMass-Lowell,2,0,1,1,0.50,0,0
1005,Carter King (C/LW),University of Denver,3,0,1,1,0.33,0,1
1006,Cody Schiavon (D),University of Vermont,3,0,1,1,0.33,0,0
1007,Lane Krenzen (D),University of Denver,3,0,1,1,0.33,4,1
1008,Michael Gilroy (D),Sacred Heart University,4,0,1,1,0.25,0,-4
1009,Christian Simeone (F),Merrimack College,4,0,1,1,0.25,0,0
1010,Jack Works (F),University of Denver,5,0,1,1,0.20,2,-1
1011,Tyler Paquette (RW/C),Penn State University,6,0,1,1,0.17,0,-3
1012,Dylan Mills (C),Niagara University,6,0,1,1,0.17,2,0
1013,Derek Contessa (RW),Sacred Heart University,6,0,1,1,0.17,2,-6
1014,Conner Hutchison (D),University of Vermont,6,0,1,1,0.17,8,-1
1015,Austin Kamer (RW),Michigan State University,7,0,1,1,0.14,0,-1
1016,Khristian Acosta (F),Mercyhurst University,7,0,1,1,0.14,4,2
1017,Andrew Quetell (D),Army (U.S. Military Academy),8,0,1,1,0.13,0,0
1018,Cameron Spicer (D),University of Maine,8,0,1,1,0.13,2,-4
1019,Madoka Suzuki (LW),Long Island University,8,0,1,1,0.13,2,-4
1020,Garrett Worth (F),Long Island University,8,0,1,1,0.13,2,-1
1021,Jackson MacNab (RW),College of the Holy Cross,8,0,1,1,0.13,6,-2
1022,Josh Latta (F),UMass-Lowell,9,0,1,1,0.11,4,-1
1023,Brenden Datema (D),Michigan Tech,9,0,1,1,0.11,7,-5
1024,Tanner Schachle (LW),Long Island University,9,0,1,1,0.11,24,-6
1025,Adam Tisdale (C),Sacred Heart University,10,0,1,1,0.10,0,-5
1026,Callum Cusinato (C/LW),St. Lawrence University,10,0,1,1,0.10,2,-1
1027,Josh Martin (D),University of Alabama-Huntsville,10,0,1,1,0.10,4,-2
1028,Cody Hoban (F),Sacred Heart University,10,0,1,1,0.10,6,-2
1029,Marcus Walter (D),Bentley University,11,0,1,1,0.09,0,-5
1030,Greyson Reitmeier (LW/C),Michigan Tech,11,0,1,1,0.09,2,0
1031,Ethan Roswell (D),Bentley University,11,0,1,1,0.09,4,-2
1032,Jeff Clarke (D),St. Lawrence University,11,0,1,1,0.09,4,-1
1033,Ace Cowans (C/LW),University of Vermont,11,0,1,1,0.09,6,-2
1034,Jake Nielsen (F),St. Lawrence University,11,0,1,1,0.09,15,0
1035,Adam Pitters (F),Bowling Green State University,11,0,1,1,0.09,20,1
1036,Chris Van Os-Shaw (LW),Minnesota State University (Mankato),11,0,1,1,0.09,23,1
1037,Tyler Coffey (F),Colorado College,12,0,1,1,0.08,0,1
1038,Joe Cipollone (C),University of New Hampshire,12,0,1,1,0.08,0,-3
1039,Andrius Kulbis-Marino (D),Sacred Heart University,12,0,1,1,0.08,4,3
1040,James Davenport (D),Northeastern University,12,0,1,1,0.08,4,0
1041,Nolan McElhaney (D),Long Island University,12,0,1,1,0.08,8,-4
1042,Brehdan Engum (D),UMass-Lowell,12,0,1,1,0.08,10,2
1043,Matt Lombardozzi (D),Bentley University,12,0,1,1,0.08,23,-2
1044,William Lemay (C/LW),University of Vermont,13,0,1,1,0.08,0,-1
1045,Derek Osik (C),Long Island University,13,0,1,1,0.08,0,-2
1046,Alec Mahalak (D),Miami University (Ohio),13,0,1,1,0.08,2,-2
1047,Joshua Wildauer (C),Lake Superior State University,13,0,1,1,0.08,4,-1
1048,Michael Higgins (D),College of the Holy Cross,13,0,1,1,0.08,4,-8
1049,Owen Grant (D),University of Vermont,13,0,1,1,0.08,6,-7
1050,Lucas Vanroboys (C/RW),Bentley University,13,0,1,1,0.08,37,-5
1051,Dalton Weigel (D),Air Force Academy,14,0,1,1,0.07,0,1
1052,Alex Mehnert (D),Air Force Academy,14,0,1,1,0.07,4,-5
1053,Adam Conquest (RW),Bowling Green State University,14,0,1,1,0.07,4,-1
1054,Calvon Boots (D),RIT (Rochester Inst. of Tech.),14,0,1,1,0.07,4,0
1055,Max Dorrington (RW/LW),St. Lawrence University,14,0,1,1,0.07,6,-3
1056,Ryan Dickinson (D),Ohio State University,14,0,1,1,0.07,29,-3
1057,Sam Knoblauch (RW),UMass-Lowell,15,0,1,1,0.07,4,-5
1058,John Jaworski (F),Sacred Heart University,16,0,1,1,0.06,0,-4
1059,Bryce Dolan (D),College of the Holy Cross,16,0,1,1,0.06,0,-6
1060,Cody Fleckenstein (D),Army (U.S. Military Academy),16,0,1,1,0.06,0,-1
1061,Peter Kessel (F),College of the Holy Cross,16,0,1,1,0.06,2,-9
1062,Dominic Vidoli (D),Ohio State University,16,0,1,1,0.06,4,1
1063,Ethan Harrison (F),Bentley University,16,0,1,1,0.06,6,-5
1064,Marek Korencik (D),UMass-Lowell,17,0,1,1,0.06,4,3
1065,Luke Johnson (D),Providence College,17,0,1,1,0.06,6,2
1066,Eric Esposito (LW),University of New Hampshire,17,0,1,1,0.06,20,-15
1067,Peyton Francis (C),University of Alabama-Huntsville,18,0,1,1,0.06,2,-8
1068,Joshua Corrow (D),University of Alabama-Huntsville,18,0,1,1,0.06,8,-11
1069,Darian Gotz (D),University of Minnesota-Duluth,19,0,1,1,0.05,4,1
1070,Austin Goldstein (F),Northeastern University,20,0,1,1,0.05,12,-8
1071,Kaelan Taylor (D),Clarkson University,21,0,1,1,0.05,8,3
1072,Anthony Stark (D),Colgate University,22,0,1,1,0.05,6,-5
1073,Paul DeNaples (D),Penn State University,22,0,1,1,0.05,8,-11
1074,Carsen Richels (LW),University of New Hampshire,22,0,1,1,0.05,8,-12
1075,Christian Berger (D),Penn State University,22,0,1,1,0.05,21,-10
1076,Carter Jones (F),Bemidji State University,23,0,1,1,0.04,0,-3
1077,Kale Bennett (D),Western Michigan University,23,0,1,1,0.04,4,-9
1078,Mason Palmer (D),Northern Michigan University,23,0,1,1,0.04,8,-7
1079,Max Coyle (D),Bowling Green State University,23,0,1,1,0.04,8,3
1080,Jack Gates (C),Colorado College,23,0,1,1,0.04,8,-8
1081,Mitch Andres (D),Boston College,24,0,1,1,0.04,9,2
1082,Charlie Raith (D),University of Notre Dame,25,0,1,1,0.04,4,2
1083,Arvid Henrikson (D),Lake Superior State University,29,0,1,1,0.03,27,0
1084,Quin Foreman (RW),Dartmouth College,0,0,0,0,0.00,0,0
1085,Eric Sinclair (D),University of Alaska-Anchorage,0,0,0,0,0.00,0,0
1086,Jacob Bauer (D),Western Michigan University,0,0,0,0,0.00,0,0
1087,Matthew Kellenberger (D),Princeton University,0,0,0,0,0.00,0,0
1088,Quinton Ong (RW),Yale University,0,0,0,0,0.00,0,0
1089,Matthew Allen (C),Union College,0,0,0,0,0.00,0,0
1090,Nick Abruzzese (LW/C),Harvard University,0,0,0,0,0.00,0,0
1091,Rhett Kingston (LW),Western Michigan University,0,0,0,0,0.00,0,0
1092,Alec Mehr (C),Brown University,0,0,0,0,0.00,0,0
1093,Tommy Lee (F),RPI (Rensselaer Polytech. Inst.),0,0,0,0,0.00,0,0
1094,Liam Motley (F),Cornell University,0,0,0,0,0.00,0,0
1095,Zach Court (LW),University of Alaska-Anchorage,0,0,0,0,0.00,0,0
1096,Joachim Weberg (LW),Brown University,0,0,0,0,0.00,0,0
1097,Tristan Crozier (F),Brown University,0,0,0,0,0.00,0,0
1098,James Miller (D),Northern Michigan University,0,0,0,0,0.00,0,0
1099,Cory Babichuk (D),RPI (Rensselaer Polytech. Inst.),0,0,0,0,0.00,0,0
1100,Joey Matthews (D),Dartmouth College,0,0,0,0,0.00,0,0
1101,Drayson Pears (D),University of Alaska-Anchorage,0,0,0,0,0.00,0,0
1102,Tanner Palocsik (D),Dartmouth College,0,0,0,0,0.00,0,0
1103,Patrick Smyth (F),Army (U.S. Military Academy),0,0,0,0,0.00,0,0
1104,Brock Paul (D),Dartmouth College,0,0,0,0,0.00,0,0
1105,Trevor Poeze (C),Niagara University,0,0,0,0,0.00,0,0
1106,Garrett Pyke (D),University of Alaska-Fairbanks,0,0,0,0,0.00,0,0
1107,Bradley Cocca (C),Brown University,0,0,0,0,0.00,0,0
1108,Finn Evans (RW),Princeton University,0,0,0,0,0.00,0,0
1109,Hayden Rowan (LW),Yale University,0,0,0,0,0.00,0,0
1110,Brendan Demler (D),Dartmouth College,0,0,0,0,0.00,0,0
1111,Danny DiGrande (C),RPI (Rensselaer Polytech. Inst.),0,0,0,0,0.00,0,0
1112,Cam Donaldson (C),Cornell University,0,0,0,0,0.00,0,0
1113,Aiden Beck (F),Robert Morris University,0,0,0,0,0.00,0,0
1114,Jordan Seyfert (C),Merrimack College,0,0,0,0,0.00,0,0
1115,Christopher Berger (LW),Brown University,0,0,0,0,0.00,0,0
1116,Jeff Losurdo (F),Dartmouth College,0,0,0,0,0.00,0,0
1117,Michael Young (D),Yale University,0,0,0,0,0.00,0,0
1118,Marcus Russell (F),Michigan Tech,0,0,0,0,0.00,0,0
1119,Luke Albert (D),Brown University,0,0,0,0,0.00,0,0
1120,Matthew Thom (D),Princeton University,0,0,0,0,0.00,0,0
1121,Colin Doyle (C),University of Alaska-Fairbanks,0,0,0,0,0.00,0,0
1122,Luke Keenan (C),Princeton University,0,0,0,0,0.00,0,0
1123,Matt Stienburg (C),Cornell University,0,0,0,0,0.00,0,0
1124,Wyllum Deveaux (F),Harvard University,0,0,0,0,0.00,0,0
1125,Jake Harris (LW),Brown University,0,0,0,0,0.00,0,0
1126,Tyler Campbell (C),Dartmouth College,0,0,0,0,0.00,0,0
1127,Mason Klee (D),RPI (Rensselaer Polytech. Inst.),0,0,0,0,0.00,0,0
1128,Josh Waters (F),Dartmouth College,0,0,0,0,0.00,0,0
1129,Nick Carabin (D),Princeton University,0,0,0,0,0.00,0,0
1130,Cody Haiskanen (D),Cornell University,0,0,0,0,0.00,0,0
1131,Daine Dubois (F),Long Island University,0,0,0,0,0.00,0,0
1132,Jared Kucharek (D),Western Michigan University,0,0,0,0,0.00,0,0
1133,Justin Pearson (LW),Yale University,0,0,0,0,0.00,0,0
1134,Andrew Lane (D),University of Alaska-Anchorage,0,0,0,0,0.00,0,0
1135,Mike Kennedy (D),Princeton University,0,0,0,0,0.00,0,0
1136,Sam Malinski (D),Cornell University,0,0,0,0,0.00,0,0
1137,Jonny Russell (RW),Brown University,0,0,0,0,0.00,0,0
1138,James McIsaac (C/RW),RPI (Rensselaer Polytech. Inst.),0,0,0,0,0.00,0,0
1139,Gabriel Seger (LW/C),Union College,0,0,0,0,0.00,0,0
1140,Brady Risk (RW/LW),University of Alaska-Fairbanks,0,0,0,0,0.00,0,0
1141,Nick Unruh (F),Dartmouth College,0,0,0,0,0.00,0,0
1142,Daniel Rybarik (LW),University of Alaska-Anchorage,0,0,0,0,0.00,0,0
1143,Dylan Anhorn (D),Union College,0,0,0,0,0.00,0,0
1144,Henry Marshall (F),Colgate University,0,0,0,0,0.00,0,0
1145,Brian Matthews (D),Yale University,0,0,0,0,0.00,0,0
1146,Jack Donato (F),Harvard University,0,0,0,0,0.00,0,0
1147,Kevin Hock (F),University of Maine,0,0,0,0,0.00,0,0
1148,Erkka Vänskä (F),College of the Holy Cross,0,0,0,0,0.00,0,0
1149,Baker Shore (RW),Harvard University,0,0,0,0,0.00,0,0
1150,Cole Quisenberry (F),Brown University,0,0,0,0,0.00,0,0
1151,Buddy Mrowka (D),Harvard University,0,0,0,0,0.00,0,0
1152,Collin Rutherford (C),Dartmouth College,0,0,0,0,0.00,0,0
1153,Kyle Betts (C),Cornell University,0,0,0,0,0.00,0,0
1154,Christopher Klack (C/W),Clarkson University,0,0,0,0,0.00,0,0
1155,Josh Kosack (RW),Union College,0,0,0,0,0.00,0,0
1156,Reid Yochim (D),Princeton University,0,0,0,0,0.00,0,0
1157,Brady Ferner (D),RPI (Rensselaer Polytech. Inst.),0,0,0,0,0.00,0,0
1158,Michael Maloney (F),Brown University,0,0,0,0,0.00,0,0
1159,Keenan Suthers (LW),University of Maine,0,0,0,0,0.00,0,0
1160,R.J. Murphy (C),Harvard University,0,0,0,0,0.00,0,0
1161,Nick Azar (D),Harvard University,0,0,0,0,0.00,0,0
1162,Caleb Hite (F),University of Alaska-Fairbanks,0,0,0,0,0.00,0,0
1163,Kyle Hallbauer (D),RPI (Rensselaer Polytech. Inst.),0,0,0,0,0.00,0,0
1164,Joe Leahy (D),Cornell University,0,0,0,0,0.00,0,0
1165,Colin Burston (LW),Brown University,0,0,0,0,0.00,0,0
1166,Sean Harrison (RW),Union College,0,0,0,0,0.00,0,0
1167,Jacob Paganelli (RW),Princeton University,0,0,0,0,0.00,0,0
1168,Roberts Blugers (LW/RW),University of Alaska-Fairbanks,0,0,0,0,0.00,0,0
1169,Antti Virtanen (D),University of Alaska-Fairbanks,0,0,0,0,0.00,0,0
1170,Markuss Komuls (D),University of Alaska-Fairbanks,0,0,0,0,0.00,0,0
1171,Jack Cameron (D),Dartmouth College,0,0,0,0,0.00,0,0
1172,Brenden Locke (C),Cornell University,0,0,0,0,0.00,0,0
1173,Niko Esposito-Selivanov (C),Lake Superior State University,0,0,0,0,0.00,0,0
1174,Zac Masson (RW),University of Alaska-Anchorage,0,0,0,0,0.00,0,0
1175,Didrik Henbrant (RW/C),University of Alaska-Fairbanks,0,0,0,0,0.00,0,0
1176,Jared Nash (C),University of Alaska-Anchorage,0,0,0,0,0.00,0,0
1177,Aaron McPheters (D),University of Alaska-Anchorage,0,0,0,0,0.00,0,0
1178,Harrison Markell (D),Dartmouth College,0,0,0,0,0.00,0,0
1179,Shane Sellar (F),RPI (Rensselaer Polytech. Inst.),0,0,0,0,0.00,0,0
1180,Michael Ryan (D),Union College,0,0,0,0,0.00,0,0
1181,Brayden Nicholetts (F),University of Alaska-Fairbanks,0,0,0,0,0.00,0,0
1182,MacGregor Sinclair (C),Canisius College,0,0,0,0,0.00,0,0
1183,Marshall Rifai (D),Harvard University,0,0,0,0,0.00,0,0
1184,Mark Paolini (D),Princeton University,0,0,0,0,0.00,0,0
1185,Colin Tonge (LW),Princeton University,0,0,0,0,0.00,0,0
1186,Owen Guy (C),Lake Superior State University,0,0,0,0,0.00,0,0
1187,Tyler Ghirardosi (F),Quinnipiac University,0,0,0,0,0.00,0,0
1188,Jakub Lacka (LW),RPI (Rensselaer Polytech. Inst.),0,0,0,0,0.00,0,0
1189,Neil Doef (LW),Princeton University,0,0,0,0,0.00,0,0
1190,Dorian Dawson (D),Brown University,0,0,0,0,0.00,0,0
1191,Tony Stillwell (D),Brown University,0,0,0,0,0.00,0,0
1192,Dante Palecco (LW),Yale University,0,0,0,0,0.00,0,0
1193,Michael Ufberg (D),Princeton University,0,0,0,0,0.00,0,0
1194,Anea Ferrario (D),Brown University,0,0,0,0,0.00,0,0
1195,Michael Regush (C),Cornell University,0,0,0,0,0.00,0,0
1196,Chase Dubois (F),University of Alaska-Fairbanks,0,0,0,0,0.00,0,0
1197,Troy Robillard (D),University of Alaska-Anchorage,0,0,0,0,0.00,0,0
1198,Kyle Johnson (F),Yale University,0,0,0,0,0.00,0,0
1199,Matt Baker (C),Dartmouth College,0,0,0,0,0.00,0,0
1200,Filip Fornåå Svensson (C/RW),University of Alaska-Fairbanks,0,0,0,0,0.00,0,0
1201,Brady Bjork (LW/RW),University of Notre Dame,0,0,0,0,0.00,0,0
1202,Jackson Ross (D),Colorado College,0,0,0,0,0.00,0,0
1203,Jace Foskey (D),Harvard University,0,0,0,0,0.00,0,0
1204,Drew Blackmun (F),Union College,0,0,0,0,0.00,0,0
1205,Dylan Davies (D/F),RPI (Rensselaer Polytech. Inst.),0,0,0,0,0.00,0,0
1206,Joe Berg (F),Princeton University,0,0,0,0,0.00,0,0
1207,Christian LeSueur (RW),Dartmouth College,0,0,0,0,0.00,0,0
1208,Rory Herrman (F),RPI (Rensselaer Polytech. Inst.),0,0,0,0,0.00,0,0
1209,Michael Muschitiello (RW),University of Alaska-Anchorage,0,0,0,0,0.00,0,0
1210,Ian Murphy (RW/C),Princeton University,0,0,0,0,0.00,0,0
1211,Chaz Smedsrud (LW),Union College,0,0,0,0,0.00,0,0
1212,Nick Leitner (D),Bemidji State University,0,0,0,0,0.00,0,0
1213,Jordan Robert (F),Clarkson University,0,0,0,0,0.00,0,0
1214,Jack Lagerstrom (D),Cornell University,0,0,0,0,0.00,0,0
1215,Jordan Muzzillo (D),University of Alaska-Fairbanks,0,0,0,0,0.00,0,0
1216,Kevin O'Neil (RW/LW),Yale University,0,0,0,0,0.00,0,0
1217,Connor Marshall (F),Brown University,0,0,0,0,0.00,0,0
1218,Ben Taylor (RW),Brown University,0,0,0,0,0.00,0,0
1219,Tyler Welsh (C/RW),Yale University,0,0,0,0,0.00,0,0
1220,Lauri Sertti (D),RPI (Rensselaer Polytech. Inst.),0,0,0,0,0.00,0,0
1221,Christian O'Neill (C),Princeton University,0,0,0,0,0.00,0,0
1222,Kyle Koopman (D),Providence College,0,0,0,0,0.00,0,0
1223,Sam Hesler (F),Dartmouth College,0,0,0,0,0.00,0,0
1224,Billy Carrabino (D),Northeastern University,0,0,0,0,0.00,0,0
1225,Casey Dornbach (C/W),Harvard University,0,0,0,0,0.00,0,0
1226,Chris Jandric (D),University of Alaska-Fairbanks,0,0,0,0,0.00,0,0
1227,Jake Johnson (D),RPI (Rensselaer Polytech. Inst.),0,0,0,0,0.00,0,0
1228,Matty Holmes (F),Brown University,0,0,0,0,0.00,0,0
1229,Ryan Carmichael (D/F),University of Notre Dame,0,0,0,0,0.00,0,0
1230,Teddy Wooding (F),Yale University,0,0,0,0,0.00,0,0
1231,Ben Foley (D),Harvard University,0,0,0,0,0.00,0,0
1232,Preston Weeks (D),University of Alaska-Anchorage,0,0,0,0,0.00,0,0
1233,Tommy Pasanen (D),Clarkson University,0,0,0,0,0.00,0,0
1234,Maxim Andreev (C/LW),Cornell University,0,0,0,0,0.00,0,0
1235,Nathan Kelly (D),Union College,0,0,0,0,0.00,0,0
1236,Mackenzie Merriman (F),Princeton University,0,0,0,0,0.00,0,0
1237,Brayden Camrud (C),University of Alaska-Anchorage,0,0,0,0,0.00,0,0
1238,Ryan Sidorski (D),Union College,0,0,0,0,0.00,0,0
1239,Billy Jerry (C/RW),RPI (Rensselaer Polytech. Inst.),0,0,0,0,0.00,0,0
1240,Ashton Stockie (C),Mercyhurst University,0,0,0,0,0.00,0,0
1241,Tyler Watkins (F),Union College,0,0,0,0,0.00,0,0
1242,Anton Rubtsov (F),University of Alaska-Fairbanks,0,0,0,0,0.00,0,0
1243,Chongmin Lee (F),University of Alaska-Anchorage,0,0,0,0,0.00,0,0
1244,Ture Linden (C),RPI (Rensselaer Polytech. Inst.),0,0,0,0,0.00,0,0
1245,Luke Rowe (D),Air Force Academy,0,0,0,0,0.00,0,0
1246,Brandon Estes (D),Union College,0,0,0,0,0.00,0,0
1247,Taylor Brierley (D),Union College,0,0,0,0,0.00,0,0
1248,Noah Weber (F),University of Minnesota,0,0,0,0,0.00,0,0
1249,Brett Jewell (RW),Yale University,0,0,0,0,0.00,0,0
1250,Nathan Plessis (F),Brown University,0,0,0,0,0.00,0,0
1251,Christian Sanda (F),Union College,0,0,0,0,0.00,0,0
1252,Sean Keohan (D),Dartmouth College,0,0,0,0,0.00,0,0
1253,Steve Holtz (D),University of Michigan,0,0,0,0,0.00,0,0
1254,Jed Pietila (D),Michigan Tech,0,0,0,0,0.00,0,0
1255,Travis Mitchell (D),Cornell University,0,0,0,0,0.00,0,0
1256,Graham Lillibridge (D),Yale University,0,0,0,0,0.00,0,0
1257,Parker Brown (F),Air Force Academy,0,0,0,0,0.00,0,0
1258,Jake Gagnon (RW),RPI (Rensselaer Polytech. Inst.),0,0,0,0,0.00,0,0
1259,Austin Jouppi (F),Bemidji State University,0,0,0,0,0.00,0,0
1260,Ryan Lovett (F),Dartmouth College,0,0,0,0,0.00,0,0
1261,Tony Andreozzi (D),Brown University,0,0,0,0,0.00,0,0
1262,John Murray (D),Harvard University,0,0,0,0,0.00,0,0
1263,Altti Nykänen (F),RPI (Rensselaer Polytech. Inst.),0,0,0,0,0.00,0,0
1264,Mitchell Perrault (F),Harvard University,0,0,0,0,0.00,0,0
1265,Harrison Israels (C),University of Alaska-Fairbanks,0,0,0,0,0.00,0,0
1266,Gleb Murtazin (RW),Union College,0,0,0,0,0.00,0,0
1267,Matt Sutton (F),Brown University,0,0,0,0,0.00,0,0
1268,Brady Meyer (C),University of Minnesota-Duluth,0,0,0,0,0.00,0,0
1269,Luke Erickson (D),St. Lawrence University,0,0,0,0,0.00,0,0
1270,Matt Koethe (F),University of Alaska-Fairbanks,0,0,0,0,0.00,0,0
1271,Liam Robertson (C),Union College,0,0,0,0,0.00,0,0
1272,Tim Rego (D),Cornell University,0,0,0,0,0.00,0,0
1273,James Crossman (D),Brown University,0,0,0,0,0.00,0,0
1274,Riley Murphy (F),University of Alaska-Fairbanks,0,0,0,0,0.00,0,0
1275,Trevor Adams (F),Union College,0,0,0,0,0.00,0,0
1276,Zach Bramwell (F),Cornell University,0,0,0,0,0.00,0,0
1277,Justin Jallen (F),Brown University,0,0,0,0,0.00,0,0
1278,Brendan Less (D),Dartmouth College,0,0,0,0,0.00,0,0
1279,John Stampohar (D),Canisius College,0,0,0,0,0.00,0,0
1280,Casey Staum (D),Colorado College,0,0,0,0,0.00,0,0
1281,Carver Watson (D),Mercyhurst University,0,0,0,0,0.00,0,0
1282,John Beaton (C),RPI (Rensselaer Polytech. Inst.),0,0,0,0,0.00,0,0
1283,Erik Urbank (RW),Dartmouth College,0,0,0,0,0.00,0,0
1284,Fletcher Fineman (D),Union College,0,0,0,0,0.00,0,0
1285,Benjamin Tupker (LW),Cornell University,0,0,0,0,0.00,0,0
1286,Ryan Mahshie (F),RPI (Rensselaer Polytech. Inst.),0,0,0,0,0.00,0,0
1287,Zach Tupker (C),Cornell University,0,0,0,0,0.00,0,0
1288,Andrew McIntyre (RW),St. Lawrence University,0,0,0,0,0.00,0,0
1289,Brody Medeiros (D),Army (U.S. Military Academy),0,0,0,0,0.00,0,0
1290,Whim Stålberg (RW/LW),University of Vermont,0,0,0,0,0.00,0,0
1291,Marty Westhaver (F),Long Island University,0,0,0,0,0.00,0,0
1292,Sami Pharaon (D),Princeton University,0,0,0,0,0.00,0,0
1293,Ben Berard (LW),Cornell University,0,0,0,0,0.00,0,0
1294,Sebastian Dirven (D),Cornell University,0,0,0,0,0.00,0,0
1295,Simon Kjellberg (D),RPI (Rensselaer Polytech. Inst.),0,0,0,0,0.00,0,0
1296,Christian DiCesare (D),University of Notre Dame,0,0,0,0,0.00,0,0
1297,Antonio Di Paolo (D),University of Alaska-Fairbanks,0,0,0,0,0.00,0,0
1298,Andong Song (D),Cornell University,0,0,0,0,0.00,0,0
1299,Corey Andonovski (RW/LW),Princeton University,0,0,0,0,0.00,0,0
1300,Alex Cohen (C),Union College,0,0,0,0,0.00,0,0
1301,John Copeland (F/D),Boston University,0,0,0,0,0.00,0,0
1302,Jackson Hartje (D),Harvard University,0,0,0,0,0.00,0,0
1303,Ville Immonen (C),Union College,0,0,0,0,0.00,0,0
1304,Ben Solin (F),Harvard University,0,0,0,0,0.00,0,0
1305,Pito Walton (D),Princeton University,0,0,0,0,0.00,0,0
1306,Coby Mack (D),Army (U.S. Military Academy),0,0,0,0,0.00,0,0
1307,Louis Helsen (D),RPI (Rensselaer Polytech. Inst.),0,0,0,0,0.00,0,0
1308,Spencer Kersten (RW/LW),Princeton University,0,0,0,0,0.00,0,0
1309,Matthew Hayami (C),Princeton University,0,0,0,0,0.00,0,0
1310,Owen Farris (C),Union College,0,0,0,0,0.00,0,0
1311,Adam Robbins (F),Princeton University,0,0,0,0,0.00,0,0
1312,Jordan Tonelli (C/LW),Brown University,0,0,0,0,0.00,0,0
1313,Tanner Edwards (LW/C),Minnesota State University (Mankato),0,0,0,0,0.00,0,0
1314,Liam Gorman (C),Princeton University,0,0,0,0,0.00,0,0
1315,Nicolas Petruolo (D),Union College,0,0,0,0,0.00,0,0
1316,Bram Scheerer (LW),Union College,0,0,0,0,0.00,0,0
1317,Colin Schmidt (C),University of Minnesota,0,0,0,0,0.00,0,0
1318,Olivier Gauthier (LW),University of Alaska-Anchorage,0,0,0,0,0.00,0,0
1319,Azzaro Tinling (RW),University of Vermont,0,0,0,0,0.00,0,0
1320,Jakob Breault (C),University of Alaska-Fairbanks,0,0,0,0,0.00,0,0
1321,Nik Allain (F),Yale University,0,0,0,0,0.00,0,0
1322,Cole Donhauser (C/W),Yale University,0,0,0,0,0.00,0,0
1323,Corey Clifton (F),Quinnipiac University,0,0,0,0,0.00,0,0
1324,Nick Bowman (F),RPI (Rensselaer Polytech. Inst.),0,0,0,0,0.00,0,0
1325,Trevor Zins (D),St. Cloud State University,0,0,0,0,0.00,0,0
1326,Kendrick Frost (LW),Army (U.S. Military Academy),0,0,0,0,0.00,0,0
1327,Liam Watson-Brawn (D),Colgate University,1,0,0,0,0.00,0,-1
1328,Eric Huss (F),Army (U.S. Military Academy),1,0,0,0,0.00,0,0
1329,Connor Gregga (F),Minnesota State University (Mankato),1,0,0,0,0.00,0,0
1330,Spencer DenBeste (F),Lake Superior State University,1,0,0,0,0.00,0,0
1331,Matt Denman (D),University of Minnesota,1,0,0,0,0.00,0,0
1332,Cal Dybicz (D),Michigan State University,1,0,0,0,0.00,0,0
1333,Verners Egle (C/W),American International College,1,0,0,0,0.00,0,0
1334,Trevor Bishop (F),Western Michigan University,1,0,0,0,0.00,0,0
1335,Trevor St. Jean (F),Bowling Green State University,1,0,0,0,0.00,0,0
1336,Matus Spodniak (C/LW),American International College,1,0,0,0,0.00,0,0
1337,Grant Johnson (F),Northern Michigan University,1,0,0,0,0.00,0,0
1338,Ethan Phillips (C/RW),Boston University,1,0,0,0,0.00,0,0
1339,Adam Stacho (RW),American International College,1,0,0,0,0.00,0,0
1340,Nick Parody (D),Canisius College,1,0,0,0,0.00,0,0
1341,John Wojciechowski (C),University of Connecticut,1,0,0,0,0.00,0,0
1342,John Schuldt (D),University of Nebraska-Omaha,1,0,0,0,0.00,0,0
1343,Alex Mella (LW),Northeastern University,1,0,0,0,0.00,2,-1
1344,Chad Sasaki (D),Colorado College,2,0,0,0,0.00,0,-1
1345,Matt Hutton (F),Robert Morris University,2,0,0,0,0.00,0,0
1346,Michael Mannara (D),Lake Superior State University,2,0,0,0,0.00,0,0
1347,Perry Winfree (D),University of Maine,2,0,0,0,0.00,0,0
1348,Nicholas Wildgoose (RW),St. Lawrence University,2,0,0,0,0.00,0,-2
1349,Jackson Sterrett (F),UMass-Lowell,2,0,0,0,0.00,0,-2
1350,Josh Groll (C/LW),University of Michigan,2,0,0,0,0.00,0,0
1351,Matt Kinash (F),UMass-Lowell,2,0,0,0,0.00,0,0
1352,David Raisanen (F),Michigan Tech,2,0,0,0,0.00,0,-1
1353,Connor Zilisch (F),Canisius College,2,0,0,0,0.00,0,0
1354,Wyatt Head (D),Mercyhurst University,2,0,0,0,0.00,0,0
1355,Travis Kothenbeutel (F),University of Nebraska-Omaha,2,0,0,0,0.00,0,0
1356,Noah Kim (D),Air Force Academy,2,0,0,0,0.00,0,-1
1357,Jake Gingell (D),University of Michigan,2,0,0,0,0.00,0,0
1358,Max Sauvé (F),Penn State University,2,0,0,0,0.00,0,-1
1359,Filips Buncis (C),Arizona State University,2,0,0,0,0.00,0,-4
1360,Jordan Klehr (D),University of Nebraska-Omaha,2,0,0,0,0.00,0,1
1361,Oskar Strömberg (D),American International College,2,0,0,0,0.00,0,2
1362,Reed Robinson (F),Niagara University,2,0,0,0,0.00,0,2
1363,Hunter Wendt (F),Ferris State University,2,0,0,0,0.00,2,-1
1364,Billy Duma (F),Air Force Academy,2,0,0,0,0.00,2,-1
1365,Jay Powell (D),University of Alabama-Huntsville,2,0,0,0,0.00,2,0
1366,Thomas Rocco (F),St. Cloud State University,2,0,0,0,0.00,2,-4
1367,Cameron Babiak (D),Bowling Green State University,2,0,0,0,0.00,2,2
1368,Cooper Watson (D),Michigan Tech,2,0,0,0,0.00,2,0
1369,Hunter Toale (D),Bentley University,2,0,0,0,0.00,4,-1
1370,Colby Bukes (D),Minnesota State University (Mankato),3,0,0,0,0.00,0,0
1371,Devon Mussio (D),Mercyhurst University,3,0,0,0,0.00,0,-2
1372,Brian Kelly (D),University of Vermont,3,0,0,0,0.00,0,1
1373,Remy Parker (F),University of Maine,3,0,0,0,0.00,0,-1
1374,Jack Johnston (F),St. Cloud State University,3,0,0,0,0.00,0,2
1375,Quinn Warmuth (D),Robert Morris University,3,0,0,0,0.00,0,-2
1376,Kevin Sadovski (D),Merrimack College,3,0,0,0,0.00,0,0
1377,Gavin Puskar (F),University of Connecticut,3,0,0,0,0.00,0,0
1378,Dallas Comeau (W/C),University of Vermont,3,0,0,0,0.00,2,-1
1379,Dan Winslow (F),Quinnipiac University,3,0,0,0,0.00,2,-1
1380,Kaden Bohlsen (C),University of Nebraska-Omaha,3,0,0,0,0.00,2,-2
1381,Tyler Williams (C),Lake Superior State University,3,0,0,0,0.00,2,0
1382,Brian Williams (C),Colorado College,4,0,0,0,0.00,0,0
1383,Ethan Gauer (D),Bemidji State University,4,0,0,0,0.00,0,-1
1384,Cameron White (D),St. Lawrence University,4,0,0,0,0.00,0,2
1385,David Baskerville (C),Canisius College,4,0,0,0,0.00,0,-1
1386,Liam Izyk (F),Boston College,4,0,0,0,0.00,0,-1
1387,Collin Murphy (D),Northeastern University,4,0,0,0,0.00,0,0
1388,Ryan Doolin (F),Sacred Heart University,4,0,0,0,0.00,0,-7
1389,Chase Stevenson (F),University of New Hampshire,4,0,0,0,0.00,0,-1
1390,Peter Zhong (LW),Arizona State University,4,0,0,0,0.00,0,0
1391,Cameron Cook (F),Niagara University,4,0,0,0,0.00,0,-1
1392,Nick Michel (F),University of Alabama-Huntsville,4,0,0,0,0.00,2,-1
1393,Brett Willits (C),Northern Michigan University,4,0,0,0,0.00,2,0
1394,Justin Smith (D),Ferris State University,5,0,0,0,0.00,0,-1
1395,Marshal Plunkett (D),Army (U.S. Military Academy),5,0,0,0,0.00,0,1
1396,Mickey Burns (LW),University of Vermont,5,0,0,0,0.00,0,-2
1397,Austin McCarthy (F),Ferris State University,5,0,0,0,0.00,0,-3
1398,Andrew Kruse (D),Air Force Academy,5,0,0,0,0.00,0,-2
1399,Jake Higgins (D),College of the Holy Cross,5,0,0,0,0.00,0,-2
1400,Noah Jordan (RW),University of Vermont,5,0,0,0,0.00,0,0