ID,Player,Team,GP,G,A,TP,PPG,PIM,PM
1,Will Smith (C/RW),Boston College,41,25,46,71,1.73,14,25
2,Cutter Gauthier (LW/C),Boston College,41,38,27,65,1.59,18,23
3,Macklin Celebrini (C/LW),Boston University,38,32,32,64,1.68,18,25
4,Ryan Leonard (C),Boston College,41,31,29,60,1.46,38,36
5,Jackson Blake (RW/C),University of North Dakota,40,22,38,60,1.50,26,13
6,Gabe Perreault (RW),Boston College,36,19,41,60,1.67,29,24
7,Jack Devine (RW),University of Denver,44,27,29,56,1.27,20,29
8,Gavin Brindley (RW/LW),University of Michigan,40,25,28,53,1.33,28,17
9,Rutger McGroarty (C/W),University of Michigan,36,16,36,52,1.44,6,17
10,Zeev Buium (D),University of Denver,42,11,39,50,1.19,20,33
11,Dylan Duke (LW/C),University of Michigan,41,26,23,49,1.20,30,8
12,Collin Graf (RW/C),Quinnipiac University,34,22,27,49,1.44,4,23
13,Lane Hutson (D),Boston University,38,15,34,49,1.29,24,14
14,T.J. Hughes (F),University of Michigan,41,19,29,48,1.17,27,11
15,Luke Grainger (RW/C),Western Michigan University,38,14,34,48,1.26,21,10
16,Lukas Sillinger (W/C),Arizona State University,38,11,37,48,1.26,10,1
17,Liam McLinskey (RW/LW),College of the Holy Cross,39,19,28,47,1.21,32,23
18,Bradly Nadeau (W/C),University of Maine,37,19,27,46,1.24,12,20
19,Jacob Quillan (C/LW),Quinnipiac University,39,17,29,46,1.18,16,16
20,Josh Nadeau (RW/LW),University of Maine,37,18,27,45,1.22,12,14
21,Seamus Casey (D),University of Michigan,40,7,38,45,1.13,14,4
22,Dylan Wendt (RW/C),Western Michigan University,38,23,21,44,1.16,10,10
23,Gabriel Seger (LW/C),Cornell University,35,14,30,44,1.26,16,30
24,Massimo Rizzo (C),University of Denver,30,10,34,44,1.47,10,24
25,Sam Colangelo (RW/C),Western Michigan University,38,24,19,43,1.13,23,19
26,Justin Hryckowian (C/LW),Northeastern University,32,13,30,43,1.34,8,24
27,Alexander Campbell (LW/C),Northeastern University,36,22,20,42,1.17,6,13
28,Oskar Jellvik (LW/C),Boston College,41,13,29,42,1.02,16,28
29,Frank Nazar (C/RW),University of Michigan,41,17,24,41,1.00,18,-7
30,Carter Wilkie (RW),RIT (Rochester Inst. of Tech.),40,16,25,41,1.03,32,20
31,Cody Laskosky (C),RIT (Rochester Inst. of Tech.),37,14,27,41,1.11,26,16
32,Tristan Broz (C/LW),University of Denver,43,16,24,40,0.93,13,20
33,Owen McLaughlin (C),University of North Dakota,39,13,26,39,1.00,8,11
34,Elijah Gonsalves (RW/C),RIT (Rochester Inst. of Tech.),36,20,18,38,1.06,30,18
35,Gianfranco Cassaro (D),RIT (Rochester Inst. of Tech.),40,18,20,38,0.95,28,21
36,Eamon Powell (D),Boston College,40,5,33,38,0.95,8,19
37,Noah Laba (C),Colorado College,36,20,17,37,1.03,27,20
38,Cameron Berg (C/LW),University of North Dakota,40,20,17,37,0.93,8,7
39,Chris Hedden (D),Air Force Academy,38,8,29,37,0.97,37,-15
40,Tim Lovell (D),Arizona State University,36,5,32,37,1.03,48,10
41,Matt Kopperud (C),Arizona State University,38,23,13,36,0.95,45,-5
42,Will Gavin (LW/C),Air Force Academy,38,19,17,36,0.95,24,-12
43,Rhett Pitlick (LW/RW),University of Minnesota,39,19,17,36,0.92,14,8
44,Luke Haymes (C/LW),Dartmouth College,31,18,18,36,1.16,12,2
45,Jared Westcott (C/LW),Lake Superior State University,38,18,18,36,0.95,51,7
46,Isaac Gordon (C),Michigan Tech,40,18,18,36,0.90,4,8
47,Quinn Hutson (RW),Boston University,40,18,18,36,0.90,35,13
48,Jack Williams (RW/LW),Northeastern University,34,17,19,36,1.06,8,0
49,Alex Bump (LW),Western Michigan University,38,14,22,36,0.95,27,7
50,Mason Marcellus (C),Quinnipiac University,39,14,22,36,0.92,18,34
51,Bryce Brodzinski (RW),University of Minnesota,39,14,22,36,0.92,18,21
52,Ryan Greene (C),Boston University,40,12,24,36,0.90,6,0
53,Stephen Halliday (C),Ohio State University,38,10,26,36,0.95,30,-2
54,Isaac Howard (LW),Michigan State University,36,8,28,36,1.00,10,3
55,Shai Buium (D),University of Denver,43,7,29,36,0.84,14,33
56,Jeremy Wilmer (LW),Boston University,38,6,30,36,0.95,19,16
57,Veeti Miettinen (RW),St. Cloud State University,37,20,15,35,0.95,0,4
58,Jack Ricketts (C),College of the Holy Cross,39,19,16,35,0.90,78,18
59,Matthew Wilde (LW),RIT (Rochester Inst. of Tech.),40,19,16,35,0.88,16,13
60,Matteo Giampa (RW),Canisius College,36,18,17,35,0.97,8,6
61,Connor Milburn (F),Lake Superior State University,34,16,19,35,1.03,30,14
62,Sam Lipkin (LW/C),Quinnipiac University,39,15,20,35,0.90,37,15
63,Artyom Levshunov (D),Michigan State University,38,9,26,35,0.92,44,27
64,John Prokop (D),Union College,36,8,27,35,0.97,43,-8
65,Sam Morton (C/LW),Minnesota State University (Mankato),37,24,10,34,0.92,10,8
66,Ben Steeves (LW),University of Minnesota-Duluth,37,24,10,34,0.92,30,-10
67,Jimmy Snuggerud (RW),University of Minnesota,39,21,13,34,0.87,42,3
68,Riese Gaber (RW/LW),University of North Dakota,40,18,16,34,0.85,34,11
69,Garrett Schifsky (C),University of Michigan,41,16,18,34,0.83,16,17
70,Aiden Fink (RW),Penn State University,34,15,19,34,1.00,27,-3
71,Carter King (C/LW),University of Denver,37,15,19,34,0.92,2,8
72,Karsen Dorwart (LW/C),Michigan State University,38,15,19,34,0.89,28,8
73,Isaiah Fox (F),Long Island University,37,14,20,34,0.92,66,6
74,Cruz Lucius (RW),University of Wisconsin,36,13,21,34,0.94,10,0
75,Dylan Hryckowian (RW),Northeastern University,34,7,27,34,1.00,22,9
76,Miko Matikka (RW/LW),University of Denver,43,20,13,33,0.77,41,15
77,Ryland Mosley (LW/RW),Michigan Tech,40,18,15,33,0.83,10,2
78,Brady Risk (RW/LW),University of Alaska-Fairbanks,33,13,20,33,1.00,16,5
79,Oliver Moore (C),University of Minnesota,39,9,24,33,0.85,8,16
80,Dylan Anhorn (D),St. Cloud State University,38,6,27,33,0.87,34,14
81,Josh Zary (F),Long Island University,35,20,12,32,0.91,21,6
82,Joey Larson (RW/LW),Michigan State University,38,16,16,32,0.84,8,6
83,Kyler Kupka (F),St. Cloud State University,38,14,18,32,0.84,18,8
84,McKade Webster (LW),University of Denver,43,14,18,32,0.74,54,31
85,Andre Ghantous (RW/LW),Northern Michigan University,34,9,23,32,0.94,48,-3
86,David Silye (C/RW),University of Wisconsin,40,9,23,32,0.80,10,-4
87,Matt Copponi (C),Merrimack College,30,7,25,32,1.07,48,4
88,Landon Slaggert (LW/C),University of Notre Dame,36,20,11,31,0.86,10,8
89,Jaxon Nelson (C/RW),University of Minnesota,39,19,12,31,0.79,6,14
90,Joey Baez (F),Army (U.S. Military Academy),32,15,16,31,0.97,14,-10
91,Ryan Conmy (RW),University of New Hampshire,34,14,17,31,0.91,14,9
92,Dalton Bancroft (RW/LW),Cornell University,34,12,19,31,0.91,25,14
93,Chris Pappas (C),Long Island University,34,11,20,31,0.91,10,0
94,Carter Randklev (F),Niagara University,37,11,20,31,0.84,39,5
95,Matteo Costantini (C/LW),Western Michigan University,38,11,20,31,0.82,18,20
96,Dustin Manz (C/RW),American International College,39,7,24,31,0.79,28,1
97,Aiden Hansen-Bukata (D),RIT (Rochester Inst. of Tech.),37,5,26,31,0.84,28,23
98,Sean Behrens (D),University of Denver,44,4,27,31,0.70,53,25
99,Rieger Lorenz (LW/C),University of Denver,44,16,14,30,0.68,10,21
100,Ben Almquist (F),University of Alaska-Anchorage,34,14,16,30,0.88,14,10
101,Lleyton Roed (LW),Bemidji State University,38,14,16,30,0.79,16,4
102,Tyler Wallace (C),Niagara University,39,13,17,30,0.77,17,2
103,Caden Villegas (F),Union College,37,12,18,30,0.81,4,-12
104,Lucas Wahlin (RW/LW),University of St. Thomas,37,12,18,30,0.81,48,4
105,Ross Mitton (RW/LW),Colgate University,34,11,19,30,0.88,14,-4
106,Cameron Lund (C/W),Northeastern University,35,11,19,30,0.86,22,-7
107,Aidan Thompson (C/LW),University of Denver,44,11,19,30,0.68,35,16
108,Luke Tuch (LW),Boston University,39,10,20,30,0.77,10,17
109,Lynden Breen (C/LW),University of Maine,37,9,21,30,0.81,20,17
110,Noah Kane (C),Long Island University,33,8,22,30,0.91,48,-2
111,Owen Gallatin (D),University of Minnesota-Duluth,37,7,23,30,0.81,24,-17
112,Scott Morrow (D),UMass,37,6,24,30,0.81,25,3
113,Cade Mason (D),Long Island University,34,2,28,30,0.88,8,-3
114,Ethan Leyh (F),Bentley University,35,13,16,29,0.83,34,11
115,Daniel Panetta (C),Colgate University,36,13,16,29,0.81,6,2
116,Logan Pietila (RW/C),Michigan Tech,40,13,16,29,0.73,4,-2
117,Jack Musa (F),UMass,37,12,17,29,0.78,6,9
118,Andre Gasseau (C/LW),Boston College,40,12,17,29,0.73,27,17
119,Adam Robbins (F),Princeton University,30,11,18,29,0.97,8,-3
120,Danny Dzhaniyev (F),Penn State University,33,9,20,29,0.88,6,12
121,Nicolas MÃ¼ller (C/RW),Michigan State University,38,7,22,29,0.76,22,10
122,Luke Rowe (D),Air Force Academy,35,6,23,29,0.83,70,-10
123,Jake Livanavage (D),University of North Dakota,40,5,24,29,0.73,6,5
124,Matthew Wood (LW/C),University of Connecticut,35,16,12,28,0.80,43,-1
125,Gleb Veremyev (C/LW),Colorado College,37,15,13,28,0.76,55,13
126,Lucas Sowder (LW),Minnesota State University (Mankato),33,13,15,28,0.85,16,1
127,Simon Tassy (F),University of Wisconsin,40,12,16,28,0.70,47,12
128,Mathieu Gosselin (RW/LW),Clarkson University,31,11,17,28,0.90,35,3
129,Tanner Ludtke (C),University of Nebraska-Omaha,40,11,17,28,0.70,28,11
130,Kyle Penney (C),Cornell University,35,10,18,28,0.80,18,30
131,Cy LeClerc (F),University of New Hampshire,36,10,18,28,0.78,17,7
132,Clay Cosentino (F),Air Force Academy,38,10,18,28,0.74,6,-9
133,Adam Ingram (C),St. Cloud State University,38,10,18,28,0.74,18,9
134,Tyler Fukakusa (C),RIT (Rochester Inst. of Tech.),39,9,19,28,0.72,18,19
135,Anton Rubtsov (F),University of Alaska-Fairbanks,30,8,20,28,0.93,14,6
136,Garrett Dahm (F),Mercyhurst University,35,7,21,28,0.80,23,2
137,Kyle Looft (D),Bemidji State University,32,6,22,28,0.88,14,17
138,Vincent Borgesi (D),Northeastern University,34,5,23,28,0.82,10,7
139,Ben Dexheimer (D),University of Wisconsin,40,5,23,28,0.70,16,2
140,Zach Bookman (D),Merrimack College,33,4,24,28,0.85,30,-13
141,Sam Rinzel (D),University of Minnesota,39,2,26,28,0.72,20,23
142,Boris Skalos (F),Mercyhurst University,35,15,12,27,0.77,10,2
143,Harrison Scott (C/LW),University of Maine,37,15,12,27,0.73,18,6
144,Max Helgeson (F),University of Alaska-Anchorage,33,14,13,27,0.82,31,7
145,Tyler Ghirardosi (F),College of the Holy Cross,39,14,13,27,0.69,23,13
146,Joe Miller (C),Harvard University,32,13,14,27,0.84,8,-5
147,Shane Lachance (LW),Boston University,40,13,14,27,0.68,12,15
148,Jacques Bouquot (C/LW),Penn State University,34,12,15,27,0.79,22,-7
149,Brody Lamb (RW),University of Minnesota,39,12,15,27,0.69,6,-1
150,Austin Heidemann (F),RPI (Rensselaer Polytech. Inst.),37,11,16,27,0.73,8,-12
151,Mathieu De St. Phalle (RW/LW),University of Wisconsin,38,11,16,27,0.71,8,4
152,Liam Malmquist (F),University of St. Thomas,36,10,17,27,0.75,10,-7
153,Red Savage (C),Michigan State University,38,10,17,27,0.71,12,9
154,Ayrton Martino (LW),Clarkson University,31,9,18,27,0.87,8,-5
155,Josh Nixon (RW),Union College,36,9,18,27,0.75,33,-6
156,Gunnarwolfe Fontaine (LW/C),Northeastern University,36,8,19,27,0.75,6,-2
157,Brett Chorske (C/RW),Colgate University,35,7,20,27,0.77,6,9
158,Simon Labelle (LW),Colgate University,36,7,20,27,0.75,17,-5
159,Stevie Castagna (F),Bentley University,35,6,21,27,0.77,37,4
160,Boston Buckberger (D),University of Denver,44,5,22,27,0.61,27,32
161,Griffin Ludtke (D),University of Nebraska-Omaha,40,4,23,27,0.68,27,1
162,Harrison Israels (C),University of Alaska-Fairbanks,33,20,6,26,0.79,14,10
163,Tanner Klimpke (F),Robert Morris University,37,15,11,26,0.70,14,-7
164,Gavin O'Connell (RW),Michigan State University,38,15,11,26,0.68,12,8
165,Ryan McGuire (C/RW),Colgate University,34,14,12,26,0.76,31,5
166,T.J. Walsh (LW),Sacred Heart University,36,13,13,26,0.72,6,-12
167,Ryan Kirwan (LW/RW),Penn State University,36,13,13,26,0.72,10,7
168,Scooter Brickey (D),Ohio State University,37,13,13,26,0.70,32,-10
169,Jack Randl (LW),University of Nebraska-Omaha,39,13,13,26,0.67,10,5
170,Antonio Venuto (RW),Ferris State University,36,12,14,26,0.72,44,0
171,Andon Cerbone (F),Quinnipiac University,39,12,14,26,0.67,23,20
172,Ty Mueller (C),University of Nebraska-Omaha,40,11,15,26,0.65,33,9
173,Jason Ahearn (F),Niagara University,34,10,16,26,0.76,26,-6
174,John Jaworski (F),Sacred Heart University,35,10,16,26,0.74,14,-8
175,Ryan Ufko (D),UMass,37,10,16,26,0.70,14,4
176,Davis Burnside (F),Ohio State University,38,9,17,26,0.68,24,-6
177,Eric Martin (F),Bemidji State University,38,8,18,26,0.68,6,-5
178,Ryan O'Neill (F),University of St. Thomas,35,7,19,26,0.74,12,-1
179,Matthew DiMarsico (F),Penn State University,35,7,19,26,0.74,18,-12
180,Chad Hillebrand (LW/C),Western Michigan University,38,7,19,26,0.68,44,21
181,Cristophe Tellier (LW/C),Quinnipiac University,39,7,19,26,0.67,12,11
182,Evan Murr (D),Minnesota State University (Mankato),37,6,20,26,0.70,14,8
183,Tommy Bergsland (D),Colgate University,36,5,21,26,0.72,16,-1
184,Nate Hanley (C),Union College,37,4,22,26,0.70,10,-7
185,Jayden Lee (D),Quinnipiac University,39,3,23,26,0.67,8,20
186,Cooper Flinton (LW/RW),Dartmouth College,30,15,10,25,0.83,25,1
187,Jared Wright (RW),University of Denver,44,15,10,25,0.57,8,5
188,Zach Urdahl (LW/RW),University of Nebraska-Omaha,34,13,12,25,0.74,4,3
189,Dawson Tritt (F),Lake Superior State University,38,13,12,25,0.66,14,-1
190,Daniel Russell (C),Michigan State University,38,13,12,25,0.66,38,5
191,Felikss Gavars (F),St. Lawrence University,39,13,12,25,0.64,14,-9
192,Aydar Suniev (LW/RW),UMass,36,12,13,25,0.69,25,1
193,Jack Malone (RW/C),Boston College,41,12,13,25,0.61,12,7
194,Matthew Barbolini (C/LW),Miami University (Ohio),31,11,14,25,0.81,40,-4
195,Jonathan Castagna (C),Cornell University,35,11,14,25,0.71,25,20
196,Kevin Lombardi (RW/LW),Sacred Heart University,36,11,14,25,0.69,19,-10
197,Anthony Romano (C/RW),Clarkson University,27,10,15,25,0.93,4,-3
198,Sutter Muzzatti (F),RPI (Rensselaer Polytech. Inst.),33,10,15,25,0.76,79,-15
199,Jack Stockfish (C),College of the Holy Cross,32,9,16,25,0.78,10,2
200,Lucas Mercuri (C/RW),UMass,37,9,16,25,0.68,29,1
201,Ryan Naumovski (F),Augustana University,34,8,17,25,0.74,0,0
202,Matthew Guerra (F),College of the Holy Cross,38,8,17,25,0.66,51,-4
203,Max Itagaki (F),Army (U.S. Military Academy),34,6,19,25,0.74,31,-13
204,Tom Willander (D),Boston University,38,4,21,25,0.66,12,28
205,Garrett Pyke (D),University of North Dakota,39,3,22,25,0.64,14,11
206,Ryan St. Louis (LW),Brown University,30,13,11,24,0.80,4,-8
207,Brent Keefer (F),Army (U.S. Military Academy),34,13,11,24,0.71,30,-14
208,Travis Treloar (C),Quinnipiac University,30,12,12,24,0.80,14,8
209,Eric Pohlkamp (D),Bemidji State University,32,11,13,24,0.75,18,4
210,Brandon Buhr (F),Union College,35,11,13,24,0.69,4,-12
211,Patrick Moynihan (RW),University of Notre Dame,36,10,14,24,0.67,12,7
212,Ryan Lautenbach (RW/LW),UMass,37,10,14,24,0.65,29,2
213,Zachary Okabe (RW),St. Cloud State University,38,10,14,24,0.63,21,-4
214,Riley Thompson (F),University of Alaska-Anchorage,34,9,15,24,0.71,32,13
215,Nick Poisson (F),Providence College,35,9,15,24,0.69,16,8
216,Donavan Houle (C/RW),University of Maine,36,9,15,24,0.67,33,10
217,Timo Bakos (F),Lake Superior State University,38,9,15,24,0.63,6,-3
218,Nash Nienhuis (D),Michigan State University,38,9,15,24,0.63,22,20
219,Charles-Alexis Legault (D),Quinnipiac University,39,9,15,24,0.62,53,36
220,Charlie Schoen (RW),Arizona State University,33,8,16,24,0.73,31,5
221,Ville Immonen (C),Union College,36,8,16,24,0.67,18,-6
222,Harrison Roy (F),Lake Superior State University,38,8,16,24,0.63,8,-17
223,Brendan Gorman (C),Princeton University,29,7,17,24,0.83,19,5
224,David Jacobs (RW),Princeton University,30,7,17,24,0.80,18,-3
225,Christian Fitzgerald (F),University of Wisconsin,37,7,17,24,0.65,16,8
226,Nick Bochen (D),Bentley University,35,6,18,24,0.69,20,15
227,Carter Jones (F),Bemidji State University,37,6,18,24,0.65,12,-1
228,Julius Janhonen (C),American International College,40,5,19,24,0.60,27,-2
229,Davis Pennington (D),Quinnipiac University,39,3,21,24,0.62,14,23
230,Alex Jefferies (LW),Merrimack College,22,13,10,23,1.05,19,1
231,Alex DiPaolo (LW),Colgate University,26,12,11,23,0.88,16,1
232,Ian Murphy (RW/C),Princeton University,25,11,12,23,0.92,10,1
233,P.J. Fletcher (C/RW),Miami University (Ohio),36,11,12,23,0.64,18,-12
234,Artem Shlaine (C),Northern Michigan University,27,10,13,23,0.85,23,-5
235,Liam Robertson (C),Union College,34,10,13,23,0.68,20,-6
236,Ethan Phillips (C/RW),Western Michigan University,29,9,14,23,0.79,12,14
237,Danny Nelson (C/LW),University of Notre Dame,30,9,14,23,0.77,32,5
238,Max Kouznetsov (LW/C),Canisius College,36,8,15,23,0.64,39,-1
239,Adam Eisele (F),Minnesota State University (Mankato),37,8,15,23,0.62,16,3
240,Luigi Benincasa (F),Ferris State University,33,7,16,23,0.70,6,1
241,Ryan Richardson (LW),Clarkson University,35,7,16,23,0.66,12,7
242,Steven Agriogianis (RW),Mercyhurst University,35,6,17,23,0.66,8,-16
243,Dallas Tulik (F),Robert Morris University,37,6,17,23,0.62,24,-12
244,Nick Seitz (F),Princeton University,30,5,18,23,0.77,14,-3
245,Ben Robertson (D),Cornell University,35,5,18,23,0.66,2,19
246,Matthew Gleason (C),University of St. Thomas,37,5,18,23,0.62,26,2
247,Devin Kaplan (RW),Boston University,37,5,18,23,0.62,34,9
248,Mac Gadowsky (D),Army (U.S. Military Academy),28,4,19,23,0.82,8,-1
249,Verner Miettinen (C),St. Cloud State University,38,4,19,23,0.61,8,-3
250,John Lundy (F),American International College,26,14,8,22,0.85,25,9
251,Chaz Smedsrud (LW),Union College,37,14,8,22,0.59,6,-8
252,Tyler Hotson (F),RPI (Rensselaer Polytech. Inst.),37,13,9,22,0.59,32,-3
253,Ryan Walsh (C/RW),Cornell University,35,12,10,22,0.63,21,5
254,Jeremy Davidson (RW),Michigan State University,38,12,10,22,0.58,28,9
255,Alfred Lindberg (C),American International College,20,11,11,22,1.10,6,7
256,Chase Bradley (LW/C),University of Connecticut,31,11,11,22,0.71,53,4
257,Jackson Jutting (F),Bemidji State University,27,10,12,22,0.81,2,12
258,Morgan Winters (F),University of New Hampshire,33,10,12,22,0.67,19,3
259,Brian Kramer (D),American International College,35,10,12,22,0.63,35,10
260,Reese Laubach (C),Penn State University,35,10,12,22,0.63,48,4
261,Brian Carrabes (F),Minnesota State University (Mankato),36,10,12,22,0.61,6,6
262,Ryan Healey (D),Harvard University,29,9,13,22,0.76,12,-26
263,John Waldron (F),Miami University (Ohio),36,9,13,22,0.61,6,-15
264,Caige Sterzer (F),Lindenwood University,28,8,14,22,0.79,35,-6
265,Randy HernÃ¡ndez (RW),Canisius College,37,8,14,22,0.59,4,-12
266,Kenny Connors (C),UMass,37,7,15,22,0.59,14,-2
267,Jordan Biro (C),American International College,39,7,15,22,0.56,4,1
268,Michael Sacco (F),Army (U.S. Military Academy),34,6,16,22,0.65,54,-22
269,Thomas Freel (C),University of Maine,37,6,16,22,0.59,8,4
270,Brandon Chabrier (D),University of Maine,37,6,16,22,0.59,22,8
271,Walter Zacher (C),Robert Morris University,33,5,17,22,0.67,22,-6
272,Colton Huard (D),University of New Hampshire,36,5,17,22,0.61,16,1
273,Cooper Moore (D),Quinnipiac University,39,3,19,22,0.56,26,26
274,Chase Pietila (D),Michigan Tech,40,3,19,22,0.55,60,1
275,Sam Harris (LW),University of Denver,42,14,7,21,0.50,27,13
276,Mack Byers (LW),University of St. Thomas,31,13,8,21,0.68,4,9
277,Ty Daneault (RW),Merrimack College,34,13,8,21,0.62,33,-5
278,Aaron Huglen (W/C),University of Minnesota,37,13,8,21,0.57,21,-6
279,Cooper Gay (LW/RW),University of St. Thomas,29,12,9,21,0.72,28,3
280,Owen Lindmark (C/RW),University of Wisconsin,28,11,10,21,0.75,6,17
281,Kaden Bohlsen (C),Minnesota State University (Mankato),37,11,10,21,0.57,52,6
282,Jens Richards (F),University of Vermont,32,10,11,21,0.66,10,3
283,Jack Richard (F),Niagara University,34,10,11,21,0.62,33,-5
284,Ondrej Psenicka (RW),Cornell University,35,9,12,21,0.60,30,13
285,Jackson Reineke (RW/LW),Robert Morris University,37,9,12,21,0.57,43,-5
286,Zak Galambos (D),Western Michigan University,38,9,12,21,0.55,39,16
287,Glebs Prohorenkovs (F),Niagara University,39,9,12,21,0.54,21,-10
288,Marcus Joughin (F),Sacred Heart University,34,8,13,21,0.62,16,-8
289,Parker Brown (F),Air Force Academy,37,8,13,21,0.57,27,-12
290,Nicholas Moldenhauer (C/RW),University of Michigan,41,8,13,21,0.51,2,-2
291,Scout Truman (LW),UMass-Lowell,35,7,14,21,0.60,18,2
292,Connor Kurth (F),University of Minnesota,37,7,14,21,0.57,14,-5
293,Tanner Adams (RW/C),Providence College,35,6,15,21,0.60,6,1
294,Connor McMenamin (LW),University of Minnesota-Duluth,35,6,15,21,0.60,12,-9
295,Ryan Brushett (C),RPI (Rensselaer Polytech. Inst.),37,6,15,21,0.57,14,-10
296,Tanner Andrew (C),RIT (Rochester Inst. of Tech.),38,6,15,21,0.55,10,6
297,Zach Tupker (C),Quinnipiac University,39,6,15,21,0.54,24,20
298,Hudson Schandor (C),University of Connecticut,34,5,16,21,0.62,31,9
299,John Driscoll (D),Army (U.S. Military Academy),35,5,16,21,0.60,16,-18
300,Max Koskipirtti (C/W),Michigan Tech,33,4,17,21,0.64,10,4
301,Quinn Olson (LW/C),University of Minnesota-Duluth,37,4,17,21,0.57,10,-13
302,Nick Anderson (D),Colgate University,36,2,19,21,0.58,35,2
303,Mathew Shatsky (D),College of the Holy Cross,37,2,19,21,0.57,28,13
304,Theo Wallberg (D),Ohio State University,38,2,19,21,0.55,16,-10
305,Liam Devlin (F),University of New Hampshire,28,13,7,20,0.71,37,6
306,Chase Yoder (C/W),Providence College,35,11,9,20,0.57,26,-3
307,Rylee St. Onge (LW),Robert Morris University,38,11,9,20,0.53,45,-18
308,Zaccharya Wisdom (RW),Colorado College,33,10,10,20,0.61,22,7
309,Jack Works (F),Michigan Tech,35,10,10,20,0.57,17,2
310,Drew Bavaro (D),University of Notre Dame,35,10,10,20,0.57,38,-4
311,Luke Loheit (RW),University of Minnesota-Duluth,36,10,10,20,0.56,53,-8
312,Alexander Malinowski (LW/RW),American International College,27,9,11,20,0.74,23,5
313,Cole Knuble (C/RW),University of Notre Dame,36,9,11,20,0.56,12,4
314,John Herrington (C),Lake Superior State University,37,9,11,20,0.54,12,-5
315,Lars Christian RÃ¸dne (LW),Niagara University,35,8,12,20,0.57,4,-10
316,Dylan Peterson (C/RW),Boston University,35,8,12,20,0.57,73,10
317,Brock Bremer (LW),University of Nebraska-Omaha,40,8,12,20,0.50,46,1
318,Josh Groll (C/LW),Minnesota State University (Mankato),34,7,13,20,0.59,15,1
319,Tyson Gross (RW),St. Cloud State University,34,7,13,20,0.59,16,2
320,Matt Miller (RW),University of Nebraska-Omaha,37,7,13,20,0.54,19,-16
321,Drake Burgin (D),St. Lawrence University,39,7,13,20,0.51,16,-7
322,Tomas Mazura (C),St. Lawrence University,34,6,14,20,0.59,12,-5
323,Brett Rylance (C/W),American International College,38,6,14,20,0.53,31,-5
324,C.J. Foley (D),Dartmouth College,32,5,15,20,0.63,10,5
325,Payton Matsui (F),University of Alaska-Fairbanks,34,5,15,20,0.59,6,3
326,Benji Eckerle (F),Arizona State University,35,5,15,20,0.57,12,8
327,Shane Ott (F),Niagara University,38,5,15,20,0.53,25,3
328,Mikey Adamson (D),Sacred Heart University,34,4,16,20,0.59,12,-8
329,Travis Shoudy (D),Ferris State University,36,4,16,20,0.56,14,-8
330,Carter Berger (D),Western Michigan University,36,4,16,20,0.56,14,14
331,Brian Chambers (RW),Arizona State University,38,4,16,20,0.53,35,4
332,Mason Waite (D),St. Lawrence University,39,4,16,20,0.51,14,-16
333,Nikita Nikora (C/W),Dartmouth College,25,3,17,20,0.80,2,-2
334,Josh Zinger (D),Northern Michigan University,34,3,17,20,0.59,20,-11
335,Ryan Beck (C),Colorado College,34,3,17,20,0.59,26,4
336,Ryan Siedem (D),University of Notre Dame,36,3,17,20,0.56,12,16
337,Aaron Pionk (D),University of Minnesota-Duluth,37,3,17,20,0.54,22,-9
338,Luke Mittelstadt (D),University of Minnesota,38,2,18,20,0.53,14,11
339,Carson Bantle (LW/RW),University of Wisconsin,39,14,5,19,0.49,45,7
340,Hunter Johannes (LW),University of North Dakota,31,12,7,19,0.61,29,10
341,Luke Mobley (F),Augustana University,34,12,7,19,0.56,23,-5
342,Christophe Fillion (F),Quinnipiac University,39,12,7,19,0.49,29,11
343,Jack Cronin (RW),Princeton University,26,11,8,19,0.73,8,-11
344,Ricky Lyle (LW),Army (U.S. Military Academy),34,10,9,19,0.56,33,-22
345,Austin Schwartz (F),Air Force Academy,38,10,9,19,0.50,10,6
346,Benjamin Tupker (LW),Union College,34,9,10,19,0.56,24,5
347,Ethan Manderville (C),Colgate University,36,9,10,19,0.53,10,2
348,Jackson Kunz (LW),University of North Dakota,37,9,10,19,0.51,4,6
349,Adam Flammang (RW),Bemidji State University,38,9,10,19,0.50,24,18
350,Dylan James (LW),University of North Dakota,40,9,10,19,0.48,12,11
351,Kai Daniells (F),Princeton University,30,8,11,19,0.63,14,-11
352,Blake Biondi (C/RW),University of Minnesota-Duluth,34,8,11,19,0.56,29,-20
353,Mark Hillier (F),Merrimack College,35,7,12,19,0.54,2,-7
354,Mason Salquist (F),St. Cloud State University,35,7,12,19,0.54,27,5
355,Luc Wilson (F),Minnesota State University (Mankato),36,7,12,19,0.53,14,-2
356,Justin Paul (LW),St. Lawrence University,37,7,12,19,0.51,10,-14
357,Jack Hughes (C),Boston University,38,7,12,19,0.50,12,10
358,Will Margel (W/C),Mercyhurst University,31,6,13,19,0.61,10,-7
359,KristÃ³f Papp (C),Northern Michigan University,34,6,13,19,0.56,6,-3
360,Reed Lebster (RW),Michigan State University,35,6,13,19,0.54,12,11
361,Evan Werner (F),Colorado College,37,6,13,19,0.51,10,-1
362,Cade Neilson (C),University of Alaska-Fairbanks,31,5,14,19,0.61,22,8
363,Ben Brar (LW),Merrimack College,35,5,14,19,0.54,20,-18
364,Hunter Strand (C),University of Notre Dame,36,4,15,19,0.53,2,1
365,Matt DeBoer (W),College of the Holy Cross,39,4,15,19,0.49,65,-5
366,Ryan Bottrill (F),Brown University,30,3,16,19,0.63,10,-19
367,T.J. Lloyd (D),University of Alaska-Fairbanks,34,3,16,19,0.56,33,0
368,Arvils Bergmanis (D),University of Alaska-Fairbanks,31,2,17,19,0.61,39,8
369,Austin Jouppi (F),Bemidji State University,37,2,17,19,0.51,16,4
370,Remy Parker (F),Long Island University,36,13,5,18,0.50,6,-2
371,Tyler Gratton (RW),Arizona State University,36,12,6,18,0.50,18,-7
372,Jayden Perron (RW),University of North Dakota,39,11,7,18,0.46,8,-1
373,Alec Cicero (F),College of the Holy Cross,39,11,7,18,0.46,35,-3
374,Ryan O'Hara (LW),Bowling Green State University,26,10,8,18,0.69,12,-2
375,Grady Hobbs (RW/LW),RIT (Rochester Inst. of Tech.),39,10,8,18,0.46,16,4
376,David Chen (F),Yale University,30,9,9,18,0.60,19,-2
377,Jake Schneider (RW),Colgate University,35,9,9,18,0.51,12,8
378,Hudson Malinoski (C),Providence College,35,9,9,18,0.51,29,4
379,Tanner Kelly (F),Michigan State University,35,9,9,18,0.51,34,13
380,Frank Ireland (F),Stonehill College,36,9,9,18,0.50,23,-32
381,Max Montes (F),Ohio State University,37,9,9,18,0.49,17,-2
382,Grayson Constable (F),Long Island University,37,9,9,18,0.49,29,0
383,Stepan Pokorny (F),Ferris State University,36,8,10,18,0.50,26,-15
384,Simon Isabelle (RW),RIT (Rochester Inst. of Tech.),39,8,10,18,0.46,29,3
385,Max Scott (F),Brown University,22,7,11,18,0.82,12,2
386,Ryan Mansfield (LW),Bentley University,31,7,11,18,0.58,2,7
387,Jake Richard (RW/LW),University of Connecticut,36,7,11,18,0.50,6,1
388,Logan Will (F),Colorado College,37,7,11,18,0.49,12,6
389,Cole O'Hara (RW),UMass,37,7,11,18,0.49,18,-1
390,Ty Jackson (C),Arizona State University,21,6,12,18,0.86,14,6
391,Tyler Kopff (C/LW),Brown University,30,6,12,18,0.60,16,-4
392,JÃ©rÃ©mie Bucheler (D),University of Vermont,33,6,12,18,0.55,27,-3
393,Kyle Bettens (RW/C),University of Minnesota-Duluth,36,6,12,18,0.50,14,1
394,Mickey Burns (LW),Mercyhurst University,35,5,13,18,0.51,14,-7
395,Filip Forsmark (LW/RW),Merrimack College,35,5,13,18,0.51,25,-10
396,Joaquim Lemay (D),University of Nebraska-Omaha,37,5,13,18,0.49,18,-3
397,Dustin Geregach (D),Mercyhurst University,34,4,14,18,0.53,35,-13
398,Marshall Warren (D),University of Michigan,41,4,14,18,0.44,30,0
399,Noah De la Durantaye (D),Princeton University,29,3,15,18,0.62,6,-9
400,Guillaume Richard (D),Providence College,35,3,15,18,0.51,27,5
401,Cullen Ferguson (D),Union College,37,3,15,18,0.49,60,3
402,Samuel SjÃ¶lund (D),Western Michigan University,38,3,15,18,0.47,10,-1
403,Joe Palodichuk (D),University of Wisconsin,40,3,15,18,0.45,25,13
404,Owen Cole (C),UMass-Lowell,36,10,7,17,0.47,8,-8
405,William Whitelaw (C),University of Wisconsin,37,10,7,17,0.46,17,3
406,Sam Stevens (C/LW),Boston University,40,10,7,17,0.43,34,15
407,Kyle Jeffers (C/RW),Lindenwood University,26,9,8,17,0.65,4,-6
408,Jason Brancheau (F),Ferris State University,35,9,8,17,0.49,16,-9
409,Ryan Miotto (F),University of Vermont,35,9,8,17,0.49,18,-8
410,Christian Catalano (RW),RIT (Rochester Inst. of Tech.),36,9,8,17,0.47,60,13
411,Jere VÃ¤isÃ¤nen (F),Bemidji State University,37,9,8,17,0.46,4,2
412,Sean Chisholm (C/LW),Dartmouth College,28,8,9,17,0.61,11,9
413,Braiden Dorfman (F),Dartmouth College,29,8,9,17,0.59,36,1
414,Austin Brimmer (RW),Long Island University,33,8,9,17,0.52,12,-6
415,Bennett Schimek (F),Providence College,34,8,9,17,0.50,6,8
416,Kellan Hjartarson (F),Bentley University,34,8,9,17,0.50,16,7
417,Joe Cassetti (C/LW),Western Michigan University,38,8,9,17,0.45,8,-2
418,Louis Jamernik (RW),University of North Dakota,40,8,9,17,0.43,18,3
419,Sullivan Mack (C/LW),Cornell University,29,7,10,17,0.59,2,6
420,John Fusco (D),Dartmouth College,32,7,10,17,0.53,19,-6
421,Jacob Hewitt (F),Army (U.S. Military Academy),35,7,10,17,0.49,6,-5
422,Nik Hong (F),Army (U.S. Military Academy),35,7,10,17,0.49,14,-6
423,Jackson Decker (D),Canisius College,35,7,10,17,0.49,28,-2
424,Samu Salminen (C/LW),University of Connecticut,35,7,10,17,0.49,35,3
425,Raimonds Vitolins (C),Miami University (Ohio),28,6,11,17,0.61,26,-2
426,Joey Musa (F),Dartmouth College,32,6,11,17,0.53,18,0
427,Braeden Tuck (F),Sacred Heart University,33,6,11,17,0.52,6,-3
428,Luke Krys (D),Providence College,35,6,11,17,0.49,16,2
429,Nick Carabin (D),Princeton University,27,5,12,17,0.63,26,-2
430,Dovar Tinling (C),RPI (Rensselaer Polytech. Inst.),34,5,12,17,0.50,43,-7
431,Pito Walton (D),Northeastern University,36,5,12,17,0.47,30,8
432,Kevin Marx NorÃ©n (RW/LW),Northern Michigan University,30,4,13,17,0.57,14,-2
433,Trey Taylor (D),Clarkson University,35,4,13,17,0.49,27,20
434,Josh Luedtke (D),St. Cloud State University,37,4,13,17,0.46,21,2
435,Braden Birnie (F),University of Alaska-Fairbanks,33,3,14,17,0.52,21,14
436,Nicklas Andrews (D),Colorado College,37,3,14,17,0.46,29,4
437,Ryan Taylor (F),Clarkson University,24,10,6,16,0.67,4,5
438,Quinn Finley (LW),University of Wisconsin,36,10,6,16,0.44,16,3
439,Cam Thiesing (C),Ohio State University,31,9,7,16,0.52,55,-9
440,Trevor Janicke (RW/C),University of Notre Dame,32,9,7,16,0.50,16,6
441,Riley Duran (C/RW),Providence College,35,9,7,16,0.46,18,2
442,Spencer Kersten (RW/LW),Bowling Green State University,36,9,7,16,0.44,8,-8
443,Luke Mylymok (W/C),Niagara University,38,9,7,16,0.42,20,-10
444,David Gagnon (LW),Lindenwood University,28,8,8,16,0.57,25,-8
445,Porter Schachle (F),University of Alaska-Anchorage,32,8,8,16,0.50,41,-4
446,Barrett Hall (C),St. Cloud State University,33,8,8,16,0.48,16,-5
447,Arnaud Vachon (C),Augustana University,34,8,8,16,0.47,27,-4
448,Eric Ciccolini (RW),Clarkson University,34,8,8,16,0.47,28,3
449,Chase Davis (F),Bentley University,35,8,8,16,0.46,18,-5
450,Tyler Watkins (F),Union College,36,8,8,16,0.44,4,-1
451,Henri Schreifels (F),Stonehill College,36,8,8,16,0.44,28,-27
452,Austen Long (RW/C),American International College,38,8,8,16,0.42,27,5
453,Nicholas Zabaneh (C/LW),Boston University,40,8,8,16,0.40,36,11
454,Jake Southgate (C),Lindenwood University,28,7,9,16,0.57,6,-3
455,Aiden Westin (F),University of Alaska-Anchorage,29,7,9,16,0.55,17,1
456,Kyle Smolen (F),Arizona State University,36,7,9,16,0.44,59,3
457,Max Burkholder (D),Colorado College,37,7,9,16,0.43,6,6
458,Tyler Cristall (F),St. Lawrence University,39,7,9,16,0.41,12,-12
459,Nolan Sullivan (F),University of Nebraska-Omaha,40,7,9,16,0.40,40,2
460,Andrew Lucas (D),University of Connecticut,36,5,11,16,0.44,16,3
461,Philippe Chapleau (D),St. Lawrence University,39,5,11,16,0.41,8,-8
462,Cameron Johnson (C),Harvard University,32,4,12,16,0.50,4,1
463,Robert Cronin (F),University of New Hampshire,33,4,12,16,0.48,14,1
464,Simon Mack (D),Penn State University,36,4,12,16,0.44,0,3
465,Justin Janicke (LW/C),University of Notre Dame,36,4,12,16,0.44,47,-2
466,Tiernan Shoudy (F),Michigan State University,38,4,12,16,0.42,26,3
467,Xander Lamppa (F),Penn State University,35,3,13,16,0.46,40,-3
468,Lukas Gustafsson (D),Boston College,41,3,13,16,0.39,22,17
469,Chase Foley (D),Colorado College,32,2,14,16,0.50,6,0
470,Paul Fischer (D),University of Notre Dame,34,2,14,16,0.47,30,-3
471,Tanner Palocsik (D),Penn State University,36,2,14,16,0.44,8,-1
472,Tyler Duke (D),University of Michigan,38,2,14,16,0.42,50,12
473,Jacob Truscott (D),University of Michigan,41,2,14,16,0.39,41,5
474,Luke Reid (D),University of New Hampshire,36,1,15,16,0.44,18,5
475,Matt Basgall (D),Michigan State University,38,1,15,16,0.42,2,-3
476,Keanan Stewart (F),Mercyhurst University,31,10,5,15,0.48,10,-6
477,Brett Pfoh (F),Bowling Green State University,34,9,6,15,0.44,28,-3
478,Luc Laylin (F),University of St. Thomas,37,9,6,15,0.41,6,-11
479,Ryan O'Reilly (W/C),Arizona State University,37,9,6,15,0.41,18,10
480,Jimmy Glynn (F),University of Nebraska-Omaha,39,9,6,15,0.38,14,-11
481,Briggs Gammill (F),Yale University,28,8,7,15,0.54,24,0
482,Jonny Sorenson (F),University of Alaska-Fairbanks,33,8,7,15,0.45,33,2
483,Carter Batchelder (C),Lake Superior State University,34,8,7,15,0.44,14,-6
484,Kirklan Irey (F),Bemidji State University,37,8,7,15,0.41,22,4
485,Patrick Guzzo (C),Ohio State University,38,8,7,15,0.39,15,-2
486,Jack Harvey (F),Boston University,20,7,8,15,0.75,4,14
487,Ethan Zielke (F),Lindenwood University,28,7,8,15,0.54,18,-9
488,Alex Pineau (D),Brown University,30,7,8,15,0.50,20,-20
489,Cody Monds (RW/C),Clarkson University,30,7,8,15,0.50,21,-7
490,Jack O'Leary (F),Cornell University,35,7,8,15,0.43,12,15
491,Oliver Tarr (RW),Canisius College,37,7,8,15,0.41,23,2
492,Kirby Proctor (D),University of Nebraska-Omaha,40,7,8,15,0.38,8,8
493,Griffin Loughran (F),Canisius College,21,6,9,15,0.71,78,-6
494,A.J. Hodges (LW),Bentley University,29,6,9,15,0.52,2,-1
495,Kyler Head (F),Mercyhurst University,30,6,9,15,0.50,36,-14
496,Michael Citara (RW),Merrimack College,31,6,9,15,0.48,6,-2
497,Brody Waters (LW),Bowling Green State University,34,6,9,15,0.44,25,-8
498,Logan Ganie (LW),Robert Morris University,35,6,9,15,0.43,6,-13
499,Matthew Perkins (C),University of Minnesota-Duluth,35,6,9,15,0.43,12,-12
500,Ben Poisson (F),University of Maine,37,6,9,15,0.41,21,0
501,Mason McCormick (LW),Air Force Academy,38,6,9,15,0.39,44,-7
502,Jaroslav Chmelar (RW/LW),Providence College,26,5,10,15,0.58,29,7
503,Ben MacDonald (C),Harvard University,32,5,10,15,0.47,36,-10
504,A.J. Macaulay (D),University of Alaska-Fairbanks,34,5,10,15,0.44,14,9
505,Pierson Brandon (D),Colgate University,34,5,10,15,0.44,37,10
506,Josh Nodler (C/RW),Bowling Green State University,36,5,10,15,0.42,8,-22
507,Jak Vaarwerk (C),UMass-Lowell,36,5,10,15,0.42,28,-1
508,Hunter Sansbury (D),Sacred Heart University,36,5,10,15,0.42,37,-16
509,Jack Seymour (RW),College of the Holy Cross,37,5,10,15,0.41,25,5
510,Brandon Holt (D),University of Maine,33,4,11,15,0.45,18,10
511,Bret Link (RW/LW),Colorado College,35,4,11,15,0.43,6,8
512,Kyle Haskins (C),Canisius College,35,4,11,15,0.43,10,-6
513,Michael Callow (RW/LW),Harvard University,32,3,12,15,0.47,0,1
514,Will Gilson (D),University of Alaska-Anchorage,34,3,12,15,0.44,67,4
515,Mason Nevers (C),University of Minnesota,35,3,12,15,0.43,12,16
516,Aiden Dubinsky (D),University of Minnesota-Duluth,37,3,12,15,0.41,20,-12
517,Jesse Lansdell (LW),University of Nebraska-Omaha,39,3,12,15,0.38,74,1
518,Aidan Hreschuk (D),Boston College,41,2,13,15,0.37,32,21
519,Evan Bushy (D),Lake Superior State University,37,1,14,15,0.41,18,7
520,Harrison Blaisdell (C),University of New Hampshire,32,11,3,14,0.44,6,5
521,Cameron Garvey (C),Robert Morris University,37,11,3,14,0.38,19,0
522,Phip Waugh (D/C),Mercyhurst University,31,10,4,14,0.45,32,2
523,Holt Oliphant (F),Air Force Academy,38,10,4,14,0.37,10,-6
524,Ian Carpentier (C),Yale University,26,8,6,14,0.54,8,-5
525,Christopher Theodore (LW),University of Vermont,30,8,6,14,0.47,0,-9
526,Jake Gagnon (RW),RPI (Rensselaer Polytech. Inst.),30,8,6,14,0.47,8,-10
527,Nick DeSantis (F),Cornell University,35,8,6,14,0.40,30,16
528,Dylan Lugris (F),Penn State University,36,8,6,14,0.39,4,-6
529,Joshua Eernisse (F),University of Michigan,41,8,6,14,0.34,45,-5
530,Dans Locmelis (C),UMass,30,7,7,14,0.47,4,7
531,Chase Dafoe (F),University of Alaska-Fairbanks,31,7,7,14,0.45,54,4
532,Stiven Sardaryan (RW/C),University of New Hampshire,32,7,7,14,0.44,12,-4
533,Connor Marritt (F),University of Alaska-Anchorage,33,7,7,14,0.42,7,6
534,Timofei Spitserov (RW),University of Vermont,35,7,7,14,0.40,6,-11
535,Jake Percival (F),University of Connecticut,36,7,7,14,0.39,18,5
536,Victor Czerneckianair (C),Quinnipiac University,39,7,7,14,0.36,12,12
537,Ty Naaykens (F),St. Lawrence University,39,7,7,14,0.36,45,-11
538,Logan Britt (D),University of North Dakota,40,7,7,14,0.35,10,13
539,Nolan Welsh (F),Long Island University,32,6,8,14,0.44,21,1
540,Graham Gamache (F),Providence College,35,6,8,14,0.40,8,1
541,Tyrone Bronte (RW),Michigan Tech,35,6,8,14,0.40,23,0
542,Dalton Messina (F),Ohio State University,38,6,8,14,0.37,20,-10
543,Jack Horbach (RW/C),University of Wisconsin,38,6,8,14,0.37,26,15
544,McKay Hayes (C),Robert Morris University,38,6,8,14,0.37,35,-4
545,Uula Ruikka (D),Augustana University,29,5,9,14,0.48,30,-6
546,Andrew DeCarlo (F),Air Force Academy,32,5,9,14,0.44,12,-4
547,Kaleb Ergang (RW),Ferris State University,34,5,9,14,0.41,10,-7
548,Joey Muldowney (RW),University of Connecticut,35,5,9,14,0.40,12,-7
549,Martins Lavins (C),University of New Hampshire,35,5,9,14,0.40,28,5
550,Stan Cooley (C),Colorado College,37,5,9,14,0.38,14,1
551,Connor Caponi (F),University of Denver,44,5,9,14,0.32,26,4
552,Caleb MacDonald (D),University of Alaska-Fairbanks,31,4,10,14,0.45,38,13
553,Hayden Hennen (D),Augustana University,32,4,10,14,0.44,10,-8
554,Jesse Tucker (C),Clarkson University,34,4,10,14,0.41,28,4
555,Ross Roloson (D),Lake Superior State University,37,4,10,14,0.38,4,4
556,Cade Townend (D),Robert Morris University,38,4,10,14,0.37,26,-6
557,Olivier Gauthier (LW),Niagara University,39,4,10,14,0.36,33,-9
558,Greg Japchen (D),Stonehill College,30,3,11,14,0.47,10,-29
559,Jaden Grant (F),Bowling Green State University,36,3,11,14,0.39,14,-4
560,Jack Peart (D),St. Cloud State University,38,3,11,14,0.37,18,-4
561,Jacob Bengtsson (D),Boston College,40,3,11,14,0.35,18,21
562,Mike Koster (D),University of Minnesota,33,2,12,14,0.42,4,1
563,Jed Pietila (D),Michigan Tech,40,2,12,14,0.35,26,7
564,Brandon Koch (D),Minnesota State University (Mankato),34,1,13,14,0.41,18,4
565,Alex Gagne (D),University of New Hampshire,36,1,13,14,0.39,24,13
566,Carter Korpi (F),Union College,35,10,3,13,0.37,36,6
567,Jackson Niedermayer (LW),Arizona State University,33,9,4,13,0.39,10,13
568,Nick RhÃ©aume (LW/C),UMass-Lowell,34,9,4,13,0.38,32,-12
569,Casey Severo (C),Harvard University,32,8,5,13,0.41,6,-3
570,Matt Crasa (C/RW),UMass-Lowell,34,8,5,13,0.38,16,-3
571,Seth Fyten (F),Bowling Green State University,26,7,6,13,0.50,37,3
572,Trey Funk (F),Canisius College,34,7,6,13,0.38,6,-2
573,Connor Eddy (C),Northern Michigan University,34,7,6,13,0.38,40,-6
574,Arvid Caderoth (C/RW),Michigan Tech,35,7,6,13,0.37,14,-8
575,Anthony Cipollone (F),Quinnipiac University,36,7,6,13,0.36,2,13
576,Luke Manning (C/W),University of St. Thomas,37,7,6,13,0.35,14,-4
577,Matt Allen (F),University of Alaska-Anchorage,30,6,7,13,0.43,4,1
578,Chase Dubois (F),University of Alaska-Fairbanks,30,6,7,13,0.43,19,7
579,Jan Lasak (RW),St. Lawrence University,35,6,7,13,0.37,2,-3
580,Samuel Duerr (D),Bentley University,35,6,7,13,0.37,12,-11
581,Tyler Mahan (LW),RIT (Rochester Inst. of Tech.),35,6,7,13,0.37,16,10
582,Ryan Sullivan (F),Colgate University,35,6,7,13,0.37,16,6
583,John Gelatt (F),College of the Holy Cross,38,6,7,13,0.34,20,-7
584,Ben Troumbly (F),Augustana University,28,5,8,13,0.46,14,-9
585,Patrick Geary (D),Michigan State University,32,5,8,13,0.41,30,1
586,Adam Tisdale (C),University of Alaska-Anchorage,34,5,8,13,0.38,4,-6
587,Brent Johnson (D),Ohio State University,37,5,8,13,0.35,8,-1
588,Austen May (D),Providence College,30,4,9,13,0.43,4,4
589,Mac Welsher (C),Merrimack College,30,4,9,13,0.43,18,2
590,Tyler Rubin (D),Princeton University,30,4,9,13,0.43,22,2
591,Cameron MacDonald (F),Dartmouth College,31,4,9,13,0.42,8,4
592,Jacob Kraft (C),Cornell University,34,4,9,13,0.38,2,6
593,Brett Bamber (D),University of Alaska-Anchorage,34,4,9,13,0.38,17,8
594,Erik Urbank (RW),Canisius College,34,4,9,13,0.38,37,2
595,Dean Schwenninger (C),Stonehill College,36,4,9,13,0.36,32,-21
596,Trent Sambrook (D),Mercyhurst University,28,3,10,13,0.46,14,-2
597,Brett Meerman (F),Augustana University,29,3,10,13,0.45,2,-7
598,Matt Koethe (F),University of Alaska-Fairbanks,31,3,10,13,0.42,10,6
599,Ty Gagno (F),College of the Holy Cross,33,3,10,13,0.39,16,7
600,Dylan Gratton (D),Penn State University,36,3,10,13,0.36,2,1
601,Brennan Ali (C/LW),University of Notre Dame,36,3,10,13,0.36,4,3
602,Anthony Dowd (D),Arizona State University,36,3,10,13,0.36,12,-1
603,Kieran Cebrian (F),University of Denver,36,3,10,13,0.36,14,12
604,Reid Irwin (D/C),Colgate University,36,3,10,13,0.36,24,5
605,Nate Schweitzer (D),Lake Superior State University,38,3,10,13,0.34,24,-3
606,Jacob GuÃ©vin (D),University of Nebraska-Omaha,40,3,10,13,0.33,20,-9
607,Jimmy Dowd (D),Penn State University,28,2,11,13,0.46,26,-1
608,Ryan Conroy (D),Yale University,30,2,11,13,0.43,26,-1
609,David Melaragni (D),Canisius College,32,2,11,13,0.41,16,2
610,Dante Fantauzzi (D),Sacred Heart University,35,2,11,13,0.37,32,1
611,Max Smolinski (D),RPI (Rensselaer Polytech. Inst.),37,2,11,13,0.35,50,-6
612,Luke Johnson (D),Robert Morris University,39,2,11,13,0.33,10,-22
613,Alex Murray (D),Niagara University,22,1,12,13,0.59,10,-2
614,Mitchell Wolfe (D),Bemidji State University,38,1,12,13,0.34,14,15
615,Daniel Ebrahim (LW),Sacred Heart University,31,9,3,12,0.39,19,-4
616,Joey Molenaar (F),St. Cloud State University,32,8,4,12,0.38,19,4
617,Nik Armstrong-Kingcade (F),Bentley University,24,7,5,12,0.50,25,2
618,Matthew Vermaeten (F),Canisius College,30,7,5,12,0.40,20,0
619,Michael Colella (F),Northern Michigan University,34,7,5,12,0.35,6,-7
620,Brendan Gibbons (C),Air Force Academy,34,7,5,12,0.35,14,-7
621,Ethan Scardina (C),Bowling Green State University,26,6,6,12,0.46,22,-4
622,Ryan Upson (F),Bentley University,27,6,6,12,0.44,8,5
623,Nik Allain (F),Yale University,28,6,6,12,0.43,27,0
624,Arlo Merritt (C),Bentley University,30,6,6,12,0.40,4,-3
625,Owen Bohn (F),Augustana University,31,6,6,12,0.39,18,1
626,Jackson Dorrington (D),Northeastern University,33,6,6,12,0.36,6,15
627,Zach Faremouth (F),Ferris State University,34,6,6,12,0.35,24,-4
628,George Krotiris (W),Robert Morris University,36,6,6,12,0.33,19,-8
629,Ben Strinden (C),University of North Dakota,39,6,6,12,0.31,18,6
630,Isak Walther (RW),University of Vermont,24,5,7,12,0.50,6,10
631,Ryan Coughlin (F),Mercyhurst University,27,5,7,12,0.44,8,-1
632,Quinn Rudrud (F),Augustana University,29,5,7,12,0.41,12,-5
633,Chase Brand (C),Augustana University,30,5,7,12,0.40,15,-12
634,Jamie Armstrong (LW/RW),Boston College,32,5,7,12,0.38,17,4
635,Massimo-Sarantos Lombardi (C),University of Vermont,32,5,7,12,0.38,17,3
636,Tristan Sarsland (D),Clarkson University,34,5,7,12,0.35,14,8
637,Kristaps Skrastins (C),University of New Hampshire,35,5,7,12,0.34,4,3
638,John Beaton (C),RPI (Rensselaer Polytech. Inst.),32,4,8,12,0.38,2,-22
639,Dillan Bentley (F),UMass-Lowell,32,4,8,12,0.38,12,-11
640,Ryan Tattle (F),University of Connecticut,34,4,8,12,0.35,22,-8
641,Kienan Draper (RW),University of Michigan,37,4,8,12,0.32,24,4
642,Jack Millar (D),Colorado College,37,4,8,12,0.32,24,-1
643,Samuli Niinisaari (D),UMass,27,3,9,12,0.44,4,2
644,Noah Carlin (D),Niagara University,27,3,9,12,0.44,10,3
645,Matt Choupani (C),Northeastern University,28,3,9,12,0.43,8,-1
646,David Andreychuk (C/LW),Yale University,30,3,9,12,0.40,14,-10
647,Valtteri Piironen (D),Long Island University,31,3,9,12,0.39,18,-3
648,Jack Smith (C/RW),University of Minnesota-Duluth,34,3,9,12,0.35,12,0
649,Maddox Fleming (RW/LW),University of Notre Dame,35,3,9,12,0.34,8,-7
650,Kash Rasmussen (F),Michigan Tech,35,3,9,12,0.34,9,4
651,William Zapernick (C/RW),University of Vermont,35,3,9,12,0.34,14,-4
652,Isac Jonsson (D),UMass-Lowell,36,3,9,12,0.33,2,-15
653,Ralfs Bergmanis (D),University of Vermont,32,2,10,12,0.38,60,-1
654,Josef Mysak (D),Niagara University,37,2,10,12,0.32,28,-6
655,Tim Washe (C/LW),Western Michigan University,38,2,10,12,0.32,27,-5
656,Ben Meehan (D),UMass-Lowell,25,1,11,12,0.48,31,-5
657,Kyle Kukkonen (C/RW),Michigan Tech,27,1,11,12,0.44,18,-4
658,Connor Kelley (D),Providence College,34,1,11,12,0.35,12,7
659,Ethan Gauer (D),University of St. Thomas,37,0,12,12,0.32,26,-8
660,Dylan Jackson (RW),Arizona State University,15,7,4,11,0.73,18,-1
661,Jakob Lee (C),RPI (Rensselaer Polytech. Inst.),23,7,4,11,0.48,41,-3
662,Branden Piku (F),Lake Superior State University,25,7,4,11,0.44,14,6
663,Jamie Engelbert (C),Providence College,28,7,4,11,0.39,16,3
664,Kasper Magnussen (LW),Bemidji State University,29,7,4,11,0.38,6,3
665,Emerson Goode (C/W),Ferris State University,32,7,4,11,0.34,24,3
666,Sully Scholle (F),University of Maine,33,7,4,11,0.33,10,1
667,Tristan Fraser (F),University of Connecticut,35,7,4,11,0.31,33,-1
668,Nicholas Cafarelli (F),University of New Hampshire,28,6,5,11,0.39,41,2
669,Dane Dowiak (C/LW),Penn State University,31,6,5,11,0.35,24,-16
670,Connor Mylymok (RW/LW),Niagara University,37,6,5,11,0.30,61,-1
671,Marko Reifenberger (C),Mercyhurst University,33,5,6,11,0.33,37,-10
672,Quinn Emerson (RW/C),Bowling Green State University,36,5,6,11,0.31,10,1
673,Jimmy Clark (LW/C),University of Minnesota,39,5,6,11,0.28,4,5
674,Grant Silianoff (RW),University of Notre Dame,28,4,7,11,0.39,12,4
675,Matthew Campbell (D),Michigan Tech,30,4,7,11,0.37,8,-6
676,Gustav Stjernberg (D),Bowling Green State University,31,4,7,11,0.35,40,2
677,Eric Charpentier (D),Dartmouth College,32,4,7,11,0.34,25,2
678,Craig Needham (C),Providence College,34,4,7,11,0.32,31,-4
679,Ben Raymond (C/LW),Colgate University,35,4,7,11,0.31,6,2
680,Brett Callahan (D),American International College,37,4,7,11,0.30,10,1
681,Thomas Weis (C),Ohio State University,37,4,7,11,0.30,33,-3
682,Iivari RÃ¤sÃ¤nen (D),Quinnipiac University,39,4,7,11,0.28,16,25
683,Colton Friesen (F),Augustana University,24,3,8,11,0.46,6,-3
684,Andrei Buyalsky (C),University of Vermont,25,3,8,11,0.44,8,-5
685,Jaeden Mercier (F),Lindenwood University,28,3,8,11,0.39,6,-12
686,Matthew Fusco (D),Dartmouth College,28,3,8,11,0.39,10,-6
687,Steven Bellini (D),Minnesota State University (Mankato),31,3,8,11,0.35,20,4
688,Evan McIntyre (D),Augustana University,34,3,8,11,0.32,16,-10
689,Zack Nazzarett (LW),Long Island University,20,2,9,11,0.55,4,1
690,Ian Pierce (D),Dartmouth College,21,2,9,11,0.52,8,2
691,Nolan Renwick (RW/LW),University of Maine,25,2,9,11,0.44,14,-5
692,Zach Dubinsky (F),University of Vermont,30,2,9,11,0.37,20,3
693,Jordan Steinmetz (F),Minnesota State University (Mankato),32,2,9,11,0.34,10,1
694,Axel Kumlin (D),Miami University (Ohio),34,2,9,11,0.32,10,-12
695,Vincent Corcoran (D),Bemidji State University,34,2,9,11,0.32,14,-14
696,Garrett Horsager (D),Bentley University,35,2,9,11,0.31,12,12
697,Brandon Santa Juana (F),Bowling Green State University,36,2,9,11,0.31,16,-11
698,Daniel Laatsch (D),University of Wisconsin,40,2,9,11,0.28,6,17
699,Mark Cheremeta (LW),Sacred Heart University,17,1,10,11,0.65,6,-5
700,Jake Schmaltz (LW/C),University of North Dakota,36,1,10,11,0.31,13,3
701,Kabore Dunn (D),Lindenwood University,22,0,11,11,0.50,20,-6
702,Ethan Mistry (D),Brown University,30,0,11,11,0.37,6,-12
703,Thomas Messineo (D),University of Connecticut,36,0,11,11,0.31,2,8
704,Alex Gaffney (C),Harvard University,31,8,2,10,0.32,0,-18
705,Anthony Menghini (F),University of Minnesota-Duluth,37,8,2,10,0.27,43,6
706,Simon Jellus (C/LW),University of Vermont,30,6,4,10,0.33,2,-5
707,Michael Cameron (C),UMass,35,6,4,10,0.29,0,-3
708,Jake McLean (F),Bemidji State University,38,6,4,10,0.26,2,1
709,Aiden Yakimchuk (D),Lindenwood University,16,5,5,10,0.63,6,-5
710,Dalton Norris (D),Bowling Green State University,23,5,5,10,0.43,19,-9
711,Adam Pitters (F),Long Island University,31,5,5,10,0.32,10,4
712,Ryan Fine (F),Harvard University,32,5,5,10,0.31,12,-10
713,Michael Gildon (C/LW),Ohio State University,34,5,5,10,0.29,27,3
714,Drew Montgomery (F),Colorado College,35,5,5,10,0.29,12,1
715,Andrius Kulbis-Marino (D),Sacred Heart University,36,5,5,10,0.28,14,-2
716,Philippe Jacques (C),RIT (Rochester Inst. of Tech.),37,5,5,10,0.27,14,4
717,John Evans (F),RPI (Rensselaer Polytech. Inst.),16,4,6,10,0.63,2,-3
718,Klavs Veinbergs (C/LW),Colorado College,19,4,6,10,0.53,10,0
719,Stefano Bottini (LW/RW),Canisius College,23,4,6,10,0.43,10,1
720,Caden Brown (C),Ohio State University,24,4,6,10,0.42,6,-4
721,Owen Baumgartner (D),Air Force Academy,24,4,6,10,0.42,12,1
722,J.P. Turner (C),University of New Hampshire,24,4,6,10,0.42,21,1
723,Drew Kuzma (F),Lindenwood University,25,4,6,10,0.40,43,-7
724,Caleb Price (D),Lindenwood University,27,4,6,10,0.37,6,-3
725,Barrett Brooks (RW),Mercyhurst University,27,4,6,10,0.37,23,-5
726,Colby MacArthur (RW),Union College,29,4,6,10,0.34,4,-3
727,Pierce Patterson (D),Army (U.S. Military Academy),31,4,6,10,0.32,8,-11
728,Blake Wells (F),American International College,33,4,6,10,0.30,12,3
729,Rylan Van Unen (F),Northern Michigan University,33,4,6,10,0.30,55,-5
730,Vincent Salice (C),Army (U.S. Military Academy),34,4,6,10,0.29,12,-4
731,Frank Djurasevic (D),Merrimack College,35,4,6,10,0.29,26,-2
732,Victor Mancini (D),University of Nebraska-Omaha,40,4,6,10,0.25,8,7
733,Ethan Edwards (D),University of Michigan,21,3,7,10,0.48,20,13
734,William HallÃ©n (C/LW),Miami University (Ohio),23,3,7,10,0.43,8,-10
735,Ben Doran (F),Bowling Green State University,25,3,7,10,0.40,28,-4
736,Tommy Bannister (F),Mercyhurst University,27,3,7,10,0.37,4,-6
737,Ryan Alexander (C/LW),Arizona State University,27,3,7,10,0.37,10,7
738,Zachary Aughe (C),Lindenwood University,28,3,7,10,0.36,39,-7
739,Quinton Pepper (RW),University of St. Thomas,31,3,7,10,0.32,10,2
740,Gustav Blom (D),RIT (Rochester Inst. of Tech.),32,3,7,10,0.31,20,3
741,Brady Ziemer (D),Augustana University,34,3,7,10,0.29,10,-9
742,Gunnar VanDamme (D),University of Alaska-Anchorage,34,3,7,10,0.29,29,7
743,Jake Bongo (F),Sacred Heart University,36,3,7,10,0.28,4,2
744,Max Dukovac (F),Miami University (Ohio),36,3,7,10,0.28,10,-14
745,Cal Kiefiuk (F),Providence College,25,2,8,10,0.40,24,-1
746,Josh Latta (F),Bentley University,28,2,8,10,0.36,25,-2
747,Xavier Lapointe (D),RIT (Rochester Inst. of Tech.),28,2,8,10,0.36,29,12
748,Oscar Geschwind (F),American International College,32,2,8,10,0.31,8,9
749,Nick Ring (F),University of New Hampshire,34,2,8,10,0.29,6,-5
750,Kyle Gaffney (F),University of Alaska-Fairbanks,34,2,8,10,0.29,16,1
751,Tim Rego (D),Cornell University,35,2,8,10,0.29,14,21
752,Hoyt Stanley (D),Cornell University,35,2,8,10,0.29,22,16
753,Jack Mesic (D),Ferris State University,36,2,8,10,0.28,8,0
754,Brandon Tabakin (D),Arizona State University,36,2,8,10,0.28,13,26
755,Mack Oliphant (D),College of the Holy Cross,38,2,8,10,0.26,19,2
756,Nolan Krenzen (D),University of Nebraska-Omaha,40,2,8,10,0.25,4,7
757,Tommi MÃ¤nnistÃ¶ (RW),Michigan State University,32,1,9,10,0.31,39,5
758,Cal Thomas (D),University of Minnesota,38,1,9,10,0.26,8,12
759,Abram Wiebe (D),University of North Dakota,40,1,9,10,0.25,27,14
760,Luis Lindner (D/F),University of New Hampshire,36,0,10,10,0.28,2,3
761,Michael Craig (D),Robert Morris University,39,0,10,10,0.26,8,-6
762,Will Dineen (LW/RW),Yale University,20,7,2,9,0.45,27,-4
763,Matthew Johnson (F),University of Alaska-Anchorage,14,6,3,9,0.64,2,-1
764,Rhys Bentham (D),Yale University,26,6,3,9,0.35,6,-9
765,Tyler Paquette (RW/C),Penn State University,27,6,3,9,0.33,8,-14
766,Ethan Bono (F),Merrimack College,29,6,3,9,0.31,8,-2
767,Grant Slukynsky (C),Northern Michigan University,34,6,3,9,0.26,6,-3
768,Alex Young (C/W),Arizona State University,37,6,3,9,0.24,8,-5
769,Cole Spicer (C/LW),University of Minnesota-Duluth,17,5,4,9,0.53,8,2
770,Jake Cady (C),Stonehill College,26,5,4,9,0.35,25,-19
771,Ryan Sullivan (F),Miami University (Ohio),29,5,4,9,0.31,12,-8
772,Jake Higgins (D),College of the Holy Cross,31,5,4,9,0.29,17,2
773,Thomas Sinclair (C),University of Vermont,32,5,4,9,0.28,8,1
774,Tyler Carpenter (F),University of Notre Dame,33,5,4,9,0.27,16,1
775,Filip FornÃ¥Ã¥ Svensson (C/RW),UMass-Lowell,35,5,4,9,0.26,6,-5
776,Owen Ozar (F),Bowling Green State University,35,5,4,9,0.26,40,-9
777,Mark Estapa (F),University of Michigan,36,5,4,9,0.25,46,-4
778,Marcus Pedersen (RW/LW),Michigan Tech,37,5,4,9,0.24,2,-2
779,Hugh Larkin (RW),Western Michigan University,37,5,4,9,0.24,34,-5
780,Albin Nilsson (C),Miami University (Ohio),17,4,5,9,0.53,2,-12
781,Ellis Rickwood (C),Clarkson University,22,4,5,9,0.41,8,3
782,Jake Braccini (RW),University of St. Thomas,24,4,5,9,0.38,8,-8
783,Matvei Kabanov (LW),Northern Michigan University,26,4,5,9,0.35,4,-3
784,William Howard (F),Augustana University,26,4,5,9,0.35,6,-6
785,Michael Mesic (C),Northern Michigan University,26,4,5,9,0.35,8,-8
786,Joel MÃ¤Ã¤ttÃ¤ (C),University of Vermont,26,4,5,9,0.35,35,-6
787,Erik Bargholtz (F),Clarkson University,29,4,5,9,0.31,6,5
788,Liam Valente (LW/C),Providence College,29,4,5,9,0.31,10,2
789,Alex Power (C),Quinnipiac University,31,4,5,9,0.29,2,8
790,Artur Turansky (LW),Miami University (Ohio),35,4,5,9,0.26,6,-21
791,Nikolai Jenson (D),University of New Hampshire,35,4,5,9,0.26,12,7
792,Taylor Makar (LW/C),UMass,36,4,5,9,0.25,22,2
793,Ray Fust (LW/RW),University of Nebraska-Omaha,37,4,5,9,0.24,12,-6
794,Case McCarthy (D),Boston University,39,4,5,9,0.23,10,19
795,Nico Somerville (D),American International College,40,4,5,9,0.23,12,11
796,Tyler Schleppe (F),Ferris State University,25,3,6,9,0.36,11,-6
797,Jake Stella (LW),UMass-Lowell,29,3,6,9,0.31,12,-15
798,Noah Beck (D),Clarkson University,30,3,6,9,0.30,16,-17
799,Jack Robilotti (D),College of the Holy Cross,35,3,6,9,0.26,35,11
800,Josh Boyer (C),St. Lawrence University,37,3,6,9,0.24,23,-5
801,Aram Minnetian (D),Boston College,40,3,6,9,0.23,29,11
802,Tomi LeppÃ¤nen (D),American International College,40,3,6,9,0.23,39,8
803,Ben Wozney (D),Bowling Green State University,22,2,7,9,0.41,16,-3
804,Brett Bliss (D),Brown University,30,2,7,9,0.30,27,-22
805,Owen Murray (D),UMass,31,2,7,9,0.29,4,-1
806,Maxim Strbak (D),Michigan State University,32,2,7,9,0.28,17,7
807,Liam Dennison (D),Merrimack College,35,2,7,9,0.26,10,-6
808,David Breazeale (D),University of Maine,37,2,7,9,0.24,10,9
809,Luke Bast (D),University of Minnesota-Duluth,37,2,7,9,0.24,39,2
810,Anthony Kehrer (D),University of Wisconsin,38,2,7,9,0.24,23,17
811,Luke Robinson (D),Air Force Academy,38,2,7,9,0.24,32,6
812,Gavin Gulash (F),Robert Morris University,38,2,7,9,0.24,35,-7
813,C.J. McGee (D),Quinnipiac University,39,2,7,9,0.23,33,15
814,Dimitri Mikrogiannakis (D),RIT (Rochester Inst. of Tech.),40,2,7,9,0.23,41,16
815,Jack Brackett (F),RPI (Rensselaer Polytech. Inst.),33,1,8,9,0.27,4,-2
816,Will Staring (D),Air Force Academy,33,1,8,9,0.27,20,-3
817,Eric Parker (D),Bowling Green State University,33,1,8,9,0.27,29,-10
818,Brenden Datema (D),Canisius College,35,1,8,9,0.26,30,-3
819,Cameron Kungle (D),Lake Superior State University,37,1,8,9,0.24,33,1
820,Tyson Dyck (C),University of Wisconsin,28,0,9,9,0.32,21,13
821,Ryan Nicholson (D),RIT (Rochester Inst. of Tech.),40,0,9,9,0.23,22,11
822,Tanner Latsch (C),Northern Michigan University,8,7,1,8,1.00,6,-6
823,Gregory Lapointe (F),St. Lawrence University,25,6,2,8,0.32,6,0
824,Luke Devlin (C),Cornell University,28,6,2,8,0.29,12,1
825,Sawyer Scholl (RW),University of Wisconsin,33,6,2,8,0.24,20,7
826,Dylan Moulton (D),Miami University (Ohio),34,6,2,8,0.24,35,-10
827,Barron Woodring (C),Army (U.S. Military Academy),31,5,3,8,0.26,16,-6
828,Anthony Galante (F),Stonehill College,33,5,3,8,0.24,10,-25
829,Jack Jensen (LW),Augustana University,15,4,4,8,0.53,23,-4
830,Nick Granowicz (C/RW),UMass-Lowell,25,4,4,8,0.32,10,-4
831,Hunter Bischoff (F),Augustana University,26,4,4,8,0.31,2,-5
832,Alexander Nordstrom (F),Michigan Tech,26,4,4,8,0.31,6,6
833,Brett Moravec (F),Minnesota State University (Mankato),27,4,4,8,0.30,10,6
834,Zakary Karpa (C/LW),Harvard University,31,4,4,8,0.26,6,-8
835,Nick Capone (RW),University of Connecticut,32,4,4,8,0.25,46,-9
836,Cole Hanson (F),University of Maine,34,4,4,8,0.24,4,-3
837,Liam Izyk (F),Sacred Heart University,34,4,4,8,0.24,33,-4
838,Tommy Middleton (F),Colorado College,36,4,4,8,0.22,8,-4
839,Brad McNeil (F),RPI (Rensselaer Polytech. Inst.),36,4,4,8,0.22,9,-2
840,Drew Fortescue (D),Boston College,40,4,4,8,0.20,36,13
841,Jackson Hallum (F),University of Michigan,9,3,5,8,0.89,0,6
842,Joseph Dunlap (RW/C),Ohio State University,13,3,5,8,0.62,25,2
843,Karter McNarland (F),University of Alaska-Anchorage,16,3,5,8,0.50,6,3
844,Alexander Lundman (RW/LW),Bemidji State University,20,3,5,8,0.40,4,-5
845,Ian Moore (D),Harvard University,21,3,5,8,0.38,10,-6
846,Grant Ahcan (LW/RW),St. Cloud State University,23,3,5,8,0.35,15,-1
847,Matt Sutton (F),Brown University,24,3,5,8,0.33,14,-9
848,Noah Prokop (C),University of St. Thomas,27,3,5,8,0.30,16,-3
849,Adam Conquest (RW),Lindenwood University,27,3,5,8,0.30,28,-8
850,Cody Schiavon (D),Canisius College,28,3,5,8,0.29,21,2
851,Lucas Vanroboys (C/RW),UMass,29,3,5,8,0.28,22,4
852,Devlin O'Brien (LW),Merrimack College,30,3,5,8,0.27,24,-6
853,Jake Dunlap (F),Ohio State University,33,3,5,8,0.24,40,-8
854,Spencer Smith (C),Mercyhurst University,34,3,5,8,0.24,0,4
855,Aaron Bohlinger (D),UMass,34,3,5,8,0.24,4,1
856,Charlie Stramel (C/RW),University of Wisconsin,34,3,5,8,0.24,20,-4
857,Aiden Gallacher (D),Northern Michigan University,34,3,5,8,0.24,25,-2
858,Jarod Crespo (D),Penn State University,35,3,5,8,0.23,24,-9
859,Tyler Rollwagen (F),University of Nebraska-Omaha,38,3,5,8,0.21,30,1
860,Luc Salem (D),St. Lawrence University,38,3,5,8,0.21,30,-8
861,Evan Stella (D),American International College,40,3,5,8,0.20,37,-3
862,Reagan Milburn (F),Lake Superior State University,22,2,6,8,0.36,10,0
863,Matt DeMelis (F),Northeastern University,23,2,6,8,0.35,0,-4
864,Rhys Chiddenton (LW),Bemidji State University,23,2,6,8,0.35,8,2
865,Adrien Bisson (D),Mercyhurst University,23,2,6,8,0.35,16,-8
866,Christian Sarlo (F),Penn State University,25,2,6,8,0.32,2,-8
867,Jonathan Ziskie (D),Niagara University,27,2,6,8,0.30,2,-1
868,Brady Berard (C),Providence College,27,2,6,8,0.30,16,7
869,Trevor Taulien (D),Ferris State University,27,2,6,8,0.30,20,-8
870,Mason Poolman (D),University of St. Thomas,28,2,6,8,0.29,16,-1
871,Noah Hackett (F),Niagara University,29,2,6,8,0.28,0,-6
872,Luke Levandowski (F),Lake Superior State University,29,2,6,8,0.28,4,5
873,Brian Adams (F),Air Force Academy,30,2,6,8,0.27,4,7
874,Crossley Stewart (D),RIT (Rochester Inst. of Tech.),30,2,6,8,0.27,23,7
875,David Gucciardi (D),Michigan State University,30,2,6,8,0.27,47,8
876,Shay Donovan (D),Augustana University,33,2,6,8,0.24,14,-7
877,Lucas Thorne (C),College of the Holy Cross,33,2,6,8,0.24,20,-2
878,Taige Harding (D),Providence College,34,2,6,8,0.24,12,-5
879,Nick Hale (D),Ferris State University,34,2,6,8,0.24,12,3
880,Reilly Moran (F),St. Lawrence University,34,2,6,8,0.24,19,1
881,Jack Quinn (F),Long Island University,34,2,6,8,0.24,31,4
882,Jake Beaune (D),Mercyhurst University,35,2,6,8,0.23,33,4
883,Artyom Borshyov (D),Lake Superior State University,36,2,6,8,0.22,12,-8
884,Lauri Sertti (D),RPI (Rensselaer Polytech. Inst.),36,2,6,8,0.22,16,-16
885,Lane Brockhoff (D),Niagara University,37,2,6,8,0.22,54,2
886,Ryan Chesley (D),University of Minnesota,39,2,6,8,0.21,19,2
887,Colby Ambrosio (C/RW),Boston College,40,2,6,8,0.20,10,-4
888,Mike Posma (C/LW),Boston College,41,2,6,8,0.20,23,10
889,Will Vote (RW),Boston College,20,1,7,8,0.40,4,2
890,Spencer Cox (D/C),Miami University (Ohio),30,1,7,8,0.27,16,-9
891,Daniel Hilsendager (D),Western Michigan University,33,1,7,8,0.24,19,5
892,Carson Kosobud (D),University of Alaska-Anchorage,33,1,7,8,0.24,33,1
893,Kyle Heath (F),Stonehill College,35,1,7,8,0.23,10,-25
894,Hank Kempf (D),Cornell University,35,1,7,8,0.23,12,14
895,Nathan Kelly (D),Union College,35,1,7,8,0.23,23,0
896,Jack Clement (D),Miami University (Ohio),36,1,7,8,0.22,10,-13
897,Tabor Heaslip (F),University of Connecticut,36,1,7,8,0.22,16,-5
898,Hampus Rydqvist (D),Miami University (Ohio),36,1,7,8,0.22,20,-22
899,Luca Fantilli (D),University of Michigan,38,1,7,8,0.21,8,12
900,Rihards Simanovics (D),Miami University (Ohio),29,0,8,8,0.28,10,-8
901,Bennett Zmolek (D),University of North Dakota,33,0,8,8,0.24,22,17
902,Keaton Pehrson (D),University of North Dakota,35,0,8,8,0.23,10,5
903,CÃ©dric Fiedler (D),Western Michigan University,38,0,8,8,0.21,23,24
904,Charlie Leddy (D),Boston College,39,0,8,8,0.21,12,15
905,Brett Edwards (F),Northeastern University,31,5,2,7,0.23,18,-2
906,Marek Hejduk (F),Harvard University,32,5,2,7,0.22,29,-19
907,Jaxson Ezman (F),Princeton University,15,4,3,7,0.47,4,2
908,Grant Porter (F),Canisius College,16,4,3,7,0.44,4,-1
909,Donte Lawson (F),Bemidji State University,17,4,3,7,0.41,0,3
910,Justin Barker (RW),Stonehill College,24,4,3,7,0.29,10,-14
911,Casey McDonald (F),American International College,31,4,3,7,0.23,22,-8
912,Liam Walsh (LW),Northeastern University,36,4,3,7,0.19,28,-13
913,Jordan Tonelli (C/LW),Brown University,16,3,4,7,0.44,8,-9
914,Joseph Grainda (LW),Stonehill College,22,3,4,7,0.32,10,-17
915,Dominick Campione (D),Stonehill College,24,3,4,7,0.29,41,-25
916,Christian Felton (D),Merrimack College,26,3,4,7,0.27,4,-3
917,Tucker McRae (D),Dartmouth College,27,3,4,7,0.26,14,-10
918,Mitchell Allard (LW),Lindenwood University,27,3,4,7,0.26,39,-9
919,Cameron O'Neill (RW),UMass,28,3,4,7,0.25,23,0
920,Blais Richartz (F),Michigan Tech,31,3,4,7,0.23,8,5
921,Carter Slaggert (LW/RW),University of Notre Dame,32,3,4,7,0.22,24,-11
922,George Fegaras (D),Cornell University,33,3,4,7,0.21,12,9
923,Nathan Horn (F),Air Force Academy,33,3,4,7,0.21,12,-3
924,Nick Nardecchia (RW),Ferris State University,34,3,4,7,0.21,27,-15
925,Harrison Rees (D),University of Connecticut,36,3,4,7,0.19,10,-2
926,Samuel Brennan (D),Air Force Academy,36,3,4,7,0.19,16,3
927,Thomas Daskas (F),Miami University (Ohio),36,3,4,7,0.19,21,-9
928,Paul Maust (LW),Robert Morris University,36,3,4,7,0.19,41,-16
929,Ethan Szmagaj (D),Arizona State University,37,3,4,7,0.19,29,6
930,Ty Murchison (D),Arizona State University,37,3,4,7,0.19,62,7
931,Kent Anderson (D),University of Denver,41,3,4,7,0.17,12,11
932,Michael Bevilacqua (D),Bowling Green State University,20,2,5,7,0.35,2,0
933,Nick Trela (F),St. Lawrence University,28,2,5,7,0.25,10,-5
934,C.J. Regula (D),RPI (Rensselaer Polytech. Inst.),29,2,5,7,0.24,22,-3
935,Cameron Hebert (RW),Robert Morris University,33,2,5,7,0.21,20,-3
936,Jordan Di Cicco (D),Long Island University,34,2,5,7,0.21,4,-2
937,Jackson Nieuwendyk (F),Canisius College,34,2,5,7,0.21,16,0
938,Max Dorrington (RW/LW),St. Lawrence University,35,2,5,7,0.20,29,-8
939,Conor Ronayne (C),Stonehill College,35,2,5,7,0.20,32,-33
940,Ray Christy (F),Colorado College,36,2,5,7,0.19,15,1
941,Jack Agnew (D),RPI (Rensselaer Polytech. Inst.),37,2,5,7,0.19,16,-10
942,Nick Young (D),Union College,37,2,5,7,0.19,26,-2
943,Owen Michaels (F),Western Michigan University,38,2,5,7,0.18,10,6
944,Teddy Wooding (F),Yale University,21,1,6,7,0.33,8,-6
945,Ryan Nause (D),Bentley University,23,1,6,7,0.30,12,-1
946,Logan Jenuwine (F),American International College,23,1,6,7,0.30,12,-10
947,Zach Krajnik (C),Minnesota State University (Mankato),27,1,6,7,0.26,2,4
948,Cam McDonald (D),Providence College,29,1,6,7,0.24,8,5
949,Tommy Pasanen (D),Bowling Green State University,29,1,6,7,0.24,20,-12
950,Jordan Power (D),Minnesota State University (Mankato),31,1,6,7,0.23,26,1
951,Michael Mastrodomenico (D),University of Notre Dame,33,1,6,7,0.21,25,-4
952,Powell Connor (D),Canisius College,35,1,6,7,0.20,39,-4
953,Cale Ashcroft (D),University of Denver,37,1,6,7,0.19,4,-2
954,Cole Miller (D),University of St. Thomas,37,1,6,7,0.19,47,0
955,Philippe Lapointe (F),University of Michigan,39,1,6,7,0.18,28,-9
956,Philip Tresca (C),Harvard University,16,0,7,7,0.44,6,-9
957,Grant Docter (D),University of St. Thomas,22,0,7,7,0.32,8,-3
958,William Tripp (D),Stonehill College,25,0,7,7,0.28,21,-19
959,Simon Falk (RW),Augustana University,26,0,7,7,0.27,4,-3
960,Jacob Jeannette (RW),Union College,33,0,7,7,0.21,37,4
961,Nathan McBrayer (D),Ohio State University,34,0,7,7,0.21,8,1
962,Cal Mell (D),Union College,35,0,7,7,0.20,12,-4
963,Jack Judson (D),Clarkson University,35,0,7,7,0.20,57,3
964,Nick Strom (D),RPI (Rensselaer Polytech. Inst.),37,0,7,7,0.19,10,-6
965,Trevor Russell (D),Michigan Tech,38,0,7,7,0.18,30,6
966,Iisai Pesonen (C),Yale University,30,5,1,6,0.20,24,-11
967,Tyler Haskins (F),Minnesota State University (Mankato),18,4,2,6,0.33,2,0
968,Ethan Aucoin (F),St. Cloud State University,19,4,2,6,0.32,8,1
969,Cameron Buhl (F),St. Lawrence University,26,4,2,6,0.23,6,-7
970,Jack Rogers (F),St. Cloud State University,29,4,2,6,0.21,22,-4
971,Owen DuBois (F),Air Force Academy,30,4,2,6,0.20,6,-2
972,Chase McLane (C/RW),Penn State University,17,3,3,6,0.35,11,-11
973,James Goffredo (D),RPI (Rensselaer Polytech. Inst.),22,3,3,6,0.27,19,-2
974,Alex Weiermair (C),University of Denver,24,3,3,6,0.25,2,2
975,Jonathan Bendorf (LW),Bentley University,26,3,3,6,0.23,14,-6
976,Jacob Dirks (F),Ferris State University,27,3,3,6,0.22,2,-3
977,Samuel Deckhut (C),Ohio State University,29,3,3,6,0.21,2,-3
978,Preston Brodziak (F),Long Island University,29,3,3,6,0.21,10,1
979,Mitchell Becker (D),UMass-Lowell,30,3,3,6,0.20,12,-4
980,Griffin Ness (F),University of North Dakota,30,3,3,6,0.20,16,0
981,Joe Solimine (C),College of the Holy Cross,32,3,3,6,0.19,26,1
982,Cooper Wylie (D),St. Cloud State University,38,3,3,6,0.16,15,-2
983,Dario Beljo (C),American International College,16,2,4,6,0.38,12,2
984,Matt Kinash (F),University of Alaska-Anchorage,18,2,4,6,0.33,6,4
985,Jackson Munro (D),Brown University,18,2,4,6,0.33,10,-13
986,Trevor Griebel (D/F),Merrimack College,19,2,4,6,0.32,6,6
987,Blake Humphrey (C),Sacred Heart University,23,2,4,6,0.26,4,-4
988,Tristan Lemyre (C),University of Denver,24,2,4,6,0.25,0,3
989,Dominic Foglia (D),Colgate University,24,2,4,6,0.25,4,3
990,Matthew Rickard (D),American International College,25,2,4,6,0.24,8,-1
991,Jack Malinski (D),University of Vermont,26,2,4,6,0.23,16,3
992,Philip TÃ¶rnqvist (D),University of Vermont,29,2,4,6,0.21,12,1
993,Dawson Bruneski (D),University of Alaska-Fairbanks,29,2,4,6,0.21,70,1
994,Alexander Servagno (F),Penn State University,30,2,4,6,0.20,2,-5
995,Christian Berger (D),Penn State University,30,2,4,6,0.20,6,-10
996,Steven Townley (F),Dartmouth College,32,2,4,6,0.19,10,-5
997,Zach Schulz (D),University of Wisconsin,34,2,4,6,0.18,6,3
998,Damien Carfagna (D),Ohio State University,34,2,4,6,0.18,10,-10
999,Connor Joyce (C),Boston College,35,2,4,6,0.17,6,-1
1000,John Spetz (D),University of Connecticut,36,2,4,6,0.17,18,-12
1001,Nick Ahern (LW),University of Vermont,14,1,5,6,0.43,10,1
1002,Brett Roloson (F),Lake Superior State University,15,1,5,6,0.40,6,1
1003,Matthew McGroarty (F),Quinnipiac University,22,1,5,6,0.27,10,7
1004,Hunter McDonald (D),Northeastern University,23,1,5,6,0.26,32,3
1005,Cooper Haar (LW),Canisius College,25,1,5,6,0.24,16,-5
1006,Jack Bar (D),Harvard University,27,1,5,6,0.22,12,-9
1007,Daimon Gardner (C),Clarkson University,29,1,5,6,0.21,8,-7
1008,Gabriel Lunn (D),Robert Morris University,29,1,5,6,0.21,18,-16
1009,Bayard Hall (D),Yale University,30,1,5,6,0.20,10,-12
1010,Patrik Satosaari (D),Bemidji State University,31,1,5,6,0.19,8,-1
1011,Levi Glasman (LW),Colgate University,33,1,5,6,0.18,6,0
1012,Jake Flynn (D),University of Connecticut,33,1,5,6,0.18,10,-5
1013,Nicholas Remissong (F),Air Force Academy,34,1,5,6,0.18,19,-3
1014,Kaelan Taylor (D),Clarkson University,34,1,5,6,0.18,28,2
1015,Aiden Celebrini (D),Boston University,36,1,5,6,0.17,20,7
1016,Caleb Moretz (RW/C),RIT (Rochester Inst. of Tech.),39,1,5,6,0.15,8,4
1017,Seth Bernard-Docker (D),Bentley University,16,0,6,6,0.38,4,-3
1018,Jarred White (C),University of Alaska-Anchorage,24,0,6,6,0.25,12,2
1019,Joe Prouty (D),Lindenwood University,28,0,6,6,0.21,75,-14
1020,Breck McKinley (D),Bowling Green State University,31,0,6,6,0.19,6,-12
1021,Lucas Ãlvestad (D),University of Denver,32,0,6,6,0.19,14,8
1022,Darian Gotz (D),University of Minnesota-Duluth,37,0,6,6,0.16,37,-8
1023,Cade Webber (D),Boston University,38,0,6,6,0.16,30,15
1024,Cade Ahrenholz (RW),University of Alaska-Fairbanks,23,5,0,5,0.22,10,-4
1025,Tyler Coffey (F),Colorado College,24,5,0,5,0.21,10,-2
1026,Ethan Benz (F),Union College,15,4,1,5,0.33,10,1
1027,Johnny Wescoe (F),Niagara University,19,4,1,5,0.26,6,-3
1028,Danny Ciccarello (F),RPI (Rensselaer Polytech. Inst.),25,4,1,5,0.20,6,-7
1029,Nic Belpedio (D),Colgate University,9,3,2,5,0.56,2,4
1030,Lucas Coon (F),Air Force Academy,11,3,2,5,0.45,2,2
1031,Timofei Khokhlachev (LW),American International College,12,3,2,5,0.42,14,4
1032,Liam EngstrÃ¶m (F),Bemidji State University,17,3,2,5,0.29,4,-2
1033,Jake LaRusso (F),Stonehill College,19,3,2,5,0.26,10,-26
1034,Jack Collins (F),UMass-Lowell,20,3,2,5,0.25,4,-3
1035,Austin McCarthy (F),Ferris State University,20,3,2,5,0.25,4,-5
1036,Ryan Rosborough (F),St. Cloud State University,20,3,2,5,0.25,19,-10
1037,Joshua Barnes (C),American International College,22,3,2,5,0.23,2,-7
1038,Luke Weilandt (F),Merrimack College,23,3,2,5,0.22,6,-2
1039,Jan Olenginski (D),St. Lawrence University,23,3,2,5,0.22,8,-3
1040,FÃ©lix Trudeau (LW),University of Maine,24,3,2,5,0.21,6,1
1041,Ryan Shostak (F),Brown University,30,3,2,5,0.17,4,-9
1042,Max Pineo (RW),Stonehill College,31,3,2,5,0.16,10,-34
1043,Carter Loney (C),University of Minnesota-Duluth,33,3,2,5,0.15,31,-8
1044,Caiden Gault (F),Ferris State University,20,2,3,5,0.25,4,-5
1045,Ryan Mahshie (F),University of Connecticut,21,2,3,5,0.24,4,-3
1046,Killian Kiecker-Olson (C),Canisius College,21,2,3,5,0.24,15,-6
1047,Patrick Schmiedlin (C),Lindenwood University,24,2,3,5,0.21,4,-11
1048,Colton Cameron (D),Bentley University,24,2,3,5,0.21,10,2
1049,Grayson Arnott (D),University of Maine,25,2,3,5,0.20,6,3
1050,Cole Mickel (D),Niagara University,28,2,3,5,0.18,4,-5
1051,Callum Gau (F),Augustana University,28,2,3,5,0.18,20,-6
1052,Anthony Stark (D),Augustana University,30,2,3,5,0.17,4,-2
1053,Tony Andreozzi (D),Brown University,30,2,3,5,0.17,6,-1
1054,Mike Kennedy (D),Princeton University,30,2,3,5,0.17,47,-16
1055,Ethan Lund (D),Niagara University,33,2,3,5,0.15,8,-6
1056,Mark Gallant (F),Merrimack College,33,2,3,5,0.15,23,-1
1057,Will Hillman (F),Minnesota State University (Mankato),36,2,3,5,0.14,12,0
1058,Ethan Straky (D),Colorado College,37,2,3,5,0.14,16,11
1059,William Lawson-Body (F),University of Alaska-Fairbanks,10,1,4,5,0.50,15,4
1060,Sebastian Tamburro (LW),Colgate University,13,1,4,5,0.38,4,4
1061,Conner Hutchison (D),Sacred Heart University,14,1,4,5,0.36,2,-4
1062,Jack Babbage (D),University of New Hampshire,15,1,4,5,0.33,0,5
1063,Henry Bartle (F),Michigan Tech,16,1,4,5,0.31,19,5
1064,Reid Pabich (C),University of Maine,21,1,4,5,0.24,4,0
1065,Braden Fischer (LW),University of Minnesota-Duluth,22,1,4,5,0.23,2,2
1066,D.J. Hart (D),Union College,22,1,4,5,0.23,25,-6
1067,Riley Hughes (RW),Ohio State University,23,1,4,5,0.22,19,-3
1068,Tyler Catalano (C/RW),Cornell University,24,1,4,5,0.21,14,-1
1069,Nick Williams (D),Michigan Tech,25,1,4,5,0.20,8,8
1070,Hunter McCoy (F),Army (U.S. Military Academy),25,1,4,5,0.20,8,2
1071,Isack Bandu (D),Northern Michigan University,26,1,4,5,0.19,45,0
1072,Tyler Spott (D),Sacred Heart University,27,1,4,5,0.19,16,-4
1073,Nate Morgan (F),Dartmouth College,28,1,4,5,0.18,6,-1
1074,Tony Follmer (D),Bemidji State University,28,1,4,5,0.18,19,5
1075,Jack Anderson (D),Lindenwood University,28,1,4,5,0.18,40,-14
1076,Connor Pelc (RW),Mercyhurst University,29,1,4,5,0.17,14,-5
1077,Reilly Connors (C/RW),Yale University,30,1,4,5,0.17,18,-5
1078,William Smith (D),Ohio State University,32,1,4,5,0.16,22,2
1079,Tucker Hodgson (D),Bentley University,35,1,4,5,0.14,22,3
1080,Cam Gaudette (D),Stonehill College,35,1,4,5,0.14,36,-32
1081,Grant Hindman (D),Lake Superior State University,36,1,4,5,0.14,8,-5
1082,Mason Wheeler (D),Minnesota State University (Mankato),37,1,4,5,0.14,18,5
1083,Mike Vorlicky (D),University of Wisconsin,37,1,4,5,0.14,27,17
1084,Mason Klee (D),Ohio State University,38,1,4,5,0.13,25,-5
1085,Gavin McCarthy (D),Boston University,38,1,4,5,0.13,41,12
1086,Joshua Wildauer (C),Lake Superior State University,15,0,5,5,0.33,4,-3
1087,James Marooney (D),University of St. Thomas,15,0,5,5,0.33,6,5
1088,Jaiden Moriello (RW),UMass-Lowell,16,0,5,5,0.31,6,-1
1089,Tynan Ewart (D),St. Cloud State University,19,0,5,5,0.26,2,7
1090,Eli Barnett (D),University of Vermont,24,0,5,5,0.21,16,6
1091,Jimmy Doyle (RW),Bentley University,25,0,5,5,0.20,16,-5
1092,Brayden Krieger (F),Bowling Green State University,26,0,5,5,0.19,0,-7
1093,Nolan Cunningham (D),Air Force Academy,26,0,5,5,0.19,2,-2
1094,Dylan Herzog (D),Yale University,28,0,5,5,0.18,6,4
1095,Brendan Fitzgerald (D),University of New Hampshire,28,0,5,5,0.18,44,-4
1096,Oskari Vuorio (C),Dartmouth College,29,0,5,5,0.17,4,-5
1097,Connor Sullivan (D),Yale University,30,0,5,5,0.17,29,-12
1098,Mason Langenbrunner (D),Harvard University,32,0,5,5,0.16,8,-4
1099,Michael Suda (D),Cornell University,32,0,5,5,0.16,10,13
1100,William Magnuson (D),Bemidji State University,32,0,5,5,0.16,16,3
1101,Austin Oravetz (D),Michigan State University,33,0,5,5,0.15,15,8
1102,Tucker McIntosh (D),St. Lawrence University,34,0,5,5,0.15,12,-2
1103,Joseph Pierce (D),University of Minnesota-Duluth,35,0,5,5,0.14,12,-1
1104,Luke Antonacci (D),University of Maine,37,0,5,5,0.14,10,16
1105,Ty Gallagher (D),Boston University,37,0,5,5,0.14,14,3
1106,Connor Mayer (D),Colorado College,37,0,5,5,0.14,24,11
1107,Steve Holtz (D),University of Michigan,38,0,5,5,0.13,35,9
1108,Chase Stevenson (F),Merrimack College,15,4,0,4,0.27,10,-8
1109,Cole Kodsi (LW),Union College,16,3,1,4,0.25,8,-11
1110,Brayden Nicholetts (F),University of Alaska-Fairbanks,17,3,1,4,0.24,10,2
1111,Tim Piechowski (RW),University of St. Thomas,20,3,1,4,0.20,4,-7
1112,Drew Vieten (F),Niagara University,21,3,1,4,0.19,21,7
1113,Matthew Allen (C),Stonehill College,22,3,1,4,0.18,25,-24
1114,Brenden Olson (D),Minnesota State University (Mankato),23,3,1,4,0.17,10,-4
1115,Nick Traggio (D),Brown University,26,3,1,4,0.15,12,2
1116,Josh Karnish (C/LW),Princeton University,27,3,1,4,0.15,28,-13
1117,Cade DeStefani (C),Lindenwood University,9,2,2,4,0.44,6,1
1118,Matt Thomson (LW),Bentley University,12,2,2,4,0.33,8,0
1119,Jack Blanchett (D),Lake Superior State University,12,2,2,4,0.33,8,2
1120,Aaron Grounds (F),Long Island University,13,2,2,4,0.31,18,-4
1121,Theo Angesved (D),American International College,15,2,2,4,0.27,2,-3
1122,Jack Budd (D),Canisius College,15,2,2,4,0.27,6,-5
1123,Charlie Banquier (D),Stonehill College,16,2,2,4,0.25,28,-14
1124,Nicholas Niemo (F),University of Maine,17,2,2,4,0.24,4,-1
1125,Cole Craft (RW),Lake Superior State University,17,2,2,4,0.24,4,-1
1126,Reilly Funk (C),Northern Michigan University,17,2,2,4,0.24,10,-5
1127,Nick Portz (F),St. Cloud State University,17,2,2,4,0.24,14,-2
1128,Mateo Dixon (C),University of Vermont,18,2,2,4,0.22,2,1
1129,Luke van Why (D),Robert Morris University,18,2,2,4,0.22,8,4
1130,Anthony Calafiore (RW),University of Maine,19,2,2,4,0.21,0,-4
1131,JÃ©rÃ©mie Payant (C),RPI (Rensselaer Polytech. Inst.),19,2,2,4,0.21,10,-1
1132,JD Metz (F/D),University of St. Thomas,24,2,2,4,0.17,0,0
1133,Jake Black (F),University of Connecticut,24,2,2,4,0.17,2,-2
1134,Austin Fraser (F),Lindenwood University,24,2,2,4,0.17,30,-5
1135,Drew Cooper (D),Ferris State University,25,2,2,4,0.16,4,-4
1136,Xavier Alexandre Jean-Louis (D),University of Alaska-Fairbanks,26,2,2,4,0.15,20,6
1137,Gunnar Thoreson (C),St. Lawrence University,27,2,2,4,0.15,2,5
1138,Kalen Szeto (F),Yale University,27,2,2,4,0.15,23,-9
1139,Logan Acheson (D),Bemidji State University,28,2,2,4,0.14,4,0
1140,Connor Gregga (F),Minnesota State University (Mankato),28,2,2,4,0.14,8,-4
1141,Joe Berg (F),Princeton University,30,2,2,4,0.13,6,-13
1142,Jacob Slipec (F),University of Nebraska-Omaha,30,2,2,4,0.13,6,1
1143,Riley Bodnarchuk (D),University of Minnesota-Duluth,30,2,2,4,0.13,6,3
1144,Riley Wallack (F),Long Island University,30,2,2,4,0.13,8,-7
1145,Nicholas Rexine (C),Colgate University,31,2,2,4,0.13,4,-7
1146,Matt Staudacher (D),Northeastern University,31,2,2,4,0.13,8,-9
1147,Lauri Raiman (C/W),Michigan Tech,32,2,2,4,0.13,4,-13
1148,Linden Alger (D),UMass,35,2,2,4,0.11,4,5
1149,Bobby Metz (D),Colgate University,36,2,2,4,0.11,2,10
1150,Altti NykÃ¤nen (F),RPI (Rensselaer Polytech. Inst.),7,1,3,4,0.57,0,4
1151,Casper SÃ¶derling (D),American International College,12,1,3,4,0.33,2,-4
1152,Mike Van Unen (D),Northern Michigan University,17,1,3,4,0.24,8,-3
1153,Kieran Ruscheinski (D),Lindenwood University,17,1,3,4,0.24,15,2
1154,Coltan Wilkie (F),Lindenwood University,17,1,3,4,0.24,24,-1
1155,Blake Dangos (D),Sacred Heart University,19,1,3,4,0.21,16,-4
1156,Adam Arvedson (D),Merrimack College,21,1,3,4,0.19,2,-1
1157,Joseph Messina (D),Union College,22,1,3,4,0.18,10,4
1158,Alex Gomez (C/W),University of Alaska-Anchorage,23,1,3,4,0.17,6,-6
1159,Mark Cooper (D),UMass-Lowell,23,1,3,4,0.17,6,0
1160,Holden Doell (F),Ferris State University,24,1,3,4,0.17,12,-6
1161,Owen Mehlenbacher (C),University of Wisconsin,26,1,3,4,0.15,8,4
1162,Zane Demsey (D),Miami University (Ohio),26,1,3,4,0.15,25,-2
1163,Aron Jessli (LW),Niagara University,28,1,3,4,0.14,0,-11
1164,Logan Ritchie (F),St. Lawrence University,28,1,3,4,0.14,4,-13
1165,Colby Enns (D),Northern Michigan University,28,1,3,4,0.14,4,2
1166,Connor McGrath (C),Ferris State University,28,1,3,4,0.14,6,-10
1167,Liam Gorman (C),UMass,28,1,3,4,0.14,17,2
1168,Henry Wagner (LW),Yale University,30,1,3,4,0.13,10,-5
1169,Alex Peterson (F),UMass-Lowell,30,1,3,4,0.13,16,-10
1170,Ryan Sorkin (F),Dartmouth College,31,1,3,4,0.13,32,-10
1171,Jack Perbix (RW/D),Northern Michigan University,31,1,3,4,0.13,35,-8
1172,T.J. Schweighardt (D),UMass-Lowell,33,1,3,4,0.12,8,-10
1173,Andrew Noel (D),Ferris State University,35,1,3,4,0.11,4,-2
1174,Campbell Cichosz (D),Minnesota State University (Mankato),36,1,3,4,0.11,8,1
1175,Garrett Valk (D),Long Island University,36,1,3,4,0.11,14,0
1176,John Gormley (D),Long Island University,37,1,3,4,0.11,61,8
1177,Brandon Lajoie (LW),University of Alaska-Anchorage,7,0,4,4,0.57,2,2
1178,Garrett Brown (D),University of Denver,8,0,4,4,0.50,14,6
1179,Tony Malinowski (D),Minnesota State University (Mankato),13,0,4,4,0.31,4,2
1180,Hunter Jones (F),American International College,15,0,4,4,0.27,4,1
1181,Luke Farthing (D),Canisius College,15,0,4,4,0.27,6,2
1182,Jude Brower (D),Army (U.S. Military Academy),15,0,4,4,0.27,7,-2
1183,Michael Feenstra (D),Miami University (Ohio),18,0,4,4,0.22,2,0
1184,Joshua Niedermayer (D),Arizona State University,19,0,4,4,0.21,2,1
1185,Owen Desilets (D),Dartmouth College,22,0,4,4,0.18,4,1
1186,Wyatt Schingoethe (C),Western Michigan University,24,0,4,4,0.17,2,4
1187,Billy Norcross (C/RW),Northeastern University,26,0,4,4,0.15,4,-1
1188,Jakob Stender (D),Minnesota State University (Mankato),27,0,4,4,0.15,4,1
1189,Jacob Bauer (D),Western Michigan University,27,0,4,4,0.15,8,0
1190,Pat Lawn (D),Bentley University,28,0,4,4,0.14,29,1
1191,Salvatore Guzzo (F),Harvard University,29,0,4,4,0.14,10,-10
1192,Bryan Huggins (D),Lake Superior State University,30,0,4,4,0.13,6,-4
1193,Alexander Tertyshny (D),Stonehill College,30,0,4,4,0.13,16,-23
1194,Jayden Sison (RW),Princeton University,30,0,4,4,0.13,19,-5
1195,Connor Sweeney (F),University of New Hampshire,32,0,4,4,0.13,8,-2
1196,Michael Hodge (F),College of the Holy Cross,33,0,4,4,0.12,18,2
1197,Mitch Andres (D),Robert Morris University,33,0,4,4,0.12,35,-13
1198,Brehdan Engum (D),UMass-Lowell,34,0,4,4,0.12,39,-8
1199,Zachary Plucinski (D),University of Notre Dame,36,0,4,4,0.11,41,5
1200,Tyler Williams (C),Lake Superior State University,21,3,0,3,0.14,6,-9
1201,Cole Gordon (F),Arizona State University,30,3,0,3,0.10,23,4
1202,Dustyn McFaul (D),Clarkson University,35,3,0,3,0.09,24,-8
1203,Dominic Schimizzi (F),Robert Morris University,16,2,1,3,0.19,10,-3
1204,Thomas Manty (F),Brown University,18,2,1,3,0.17,4,-5
1205,Robert Kincaid (D),Canisius College,18,2,1,3,0.17,4,-3
1206,Grayson Dietrich (C/LW),American International College,19,2,1,3,0.16,18,-1
1207,Jayden Davis (C/LW),University of Notre Dame,21,2,1,3,0.14,19,-2
1208,Carson Buydens (C),Princeton University,22,2,1,3,0.14,12,-10
1209,Doug Grimes (RW),Boston University,23,2,1,3,0.13,2,3
1210,Max Wattvil (D),Merrimack College,24,2,1,3,0.13,14,2
1211,Michael Cataldo (C),Brown University,26,2,1,3,0.12,8,-11
1212,Carson Albrecht (RW),University of North Dakota,26,2,1,3,0.12,8,-1
1213,Mitchell Digby (D),Air Force Academy,27,2,1,3,0.11,11,-8
1214,Charlie Strobel (C),University of Minnesota,29,2,1,3,0.10,17,1
1215,George Grannis (F),Clarkson University,30,2,1,3,0.10,12,-4
1216,Robby Drazner (D),Miami University (Ohio),33,2,1,3,0.09,12,-12
1217,Viking Gustafsson Nyberg (D),Northern Michigan University,33,2,1,3,0.09,24,0
1218,Sasha Teleguine (F),Lake Superior State University,34,2,1,3,0.09,29,-6
1219,Blake Mesenburg (C/LW),Miami University (Ohio),36,2,1,3,0.08,16,-10
1220,Robby Newton (F),Colgate University,36,2,1,3,0.08,25,-7
1221,Devin Phillips (F),College of the Holy Cross,5,1,2,3,0.60,2,1
1222,Hunter Longhi (LW),American International College,8,1,2,3,0.38,0,1
1223,Dawson Good (F),University of Vermont,9,1,2,3,0.33,2,3
1224,Cameron Gendron (F),University of New Hampshire,10,1,2,3,0.30,2,2
1225,Hudson Lambert (D),Canisius College,13,1,2,3,0.23,6,-5
1226,Xan Gurney (D),Long Island University,13,1,2,3,0.23,36,4
1227,Adam Schankula (F),Bowling Green State University,14,1,2,3,0.21,0,0
1228,David Posma (D),Niagara University,15,1,2,3,0.20,2,-4
1229,Nicolas Ardanaz (D),RPI (Rensselaer Polytech. Inst.),18,1,2,3,0.17,6,-9
1230,Ryan Davies (D),Stonehill College,19,1,2,3,0.16,2,-18
1231,Chase Cheslock (D),University of St. Thomas,19,1,2,3,0.16,6,-3
1232,Riley Stuart (F),Colorado College,19,1,2,3,0.16,11,-4
1233,Conor Lovett (F),University of New Hampshire,20,1,2,3,0.15,0,0
1234,Easton Zueger (D),Army (U.S. Military Academy),21,1,2,3,0.14,4,-7
1235,Ivan Zivlak (D),Merrimack College,24,1,2,3,0.13,4,-13
1236,Davis Goukler (D),University of Alaska-Anchorage,24,1,2,3,0.13,6,13
1237,Ryan Hopkins (D),University of Maine,24,1,2,3,0.13,8,0
1238,Mitchel Deelstra (LW/C),Northern Michigan University,25,1,2,3,0.12,8,-2
1239,Jack Reimann (F),St. Cloud State University,25,1,2,3,0.12,12,-5
1240,Kyler Kleven (C),University of Minnesota-Duluth,25,1,2,3,0.12,13,0
1241,Luke Johnson (LW/C),University of Minnesota-Duluth,26,1,2,3,0.12,12,-3
1242,Ryan Drkulec (F),Harvard University,27,1,2,3,0.11,6,-7
1243,Lachlan Getz (D),Michigan Tech,28,1,2,3,0.11,8,-3
1244,Lucas Kanta (LW),Army (U.S. Military Academy),28,1,2,3,0.11,8,-4
1245,Broten Sabo (D),University of Alaska-Fairbanks,28,1,2,3,0.11,10,7
1246,Elan Bar-Lev-Wise (C),Yale University,28,1,2,3,0.11,30,0
1247,Ryan Gordon (C),Ohio State University,30,1,2,3,0.10,4,-3
1248,Zackary Tonelli (F),Brown University,30,1,2,3,0.10,6,-11
1249,Matthew Morden (D),Harvard University,32,1,2,3,0.09,12,-6
1250,Luca MÃ¼nzenberger (D),University of Vermont,32,1,2,3,0.09,51,2
1251,Garrett Pinoniemi (C),University of Minnesota,35,1,2,3,0.09,2,-4
1252,Zach Michaelis (C),Northern Michigan University,9,0,3,3,0.33,2,-1
1253,Austen Swankler (C),Michigan Tech,10,0,3,3,0.30,10,-4
1254,Tony Achille (F),Arizona State University,12,0,3,3,0.25,7,1
1255,Michael Abgrall (C),University of Nebraska-Omaha,12,0,3,3,0.25,10,2
1256,Sebastian TÃ¶rnqvist (D),UMass,14,0,3,3,0.21,8,1
1257,Peter Kramer (F),Bentley University,16,0,3,3,0.19,13,-1
1258,Brendan Clark (F),Brown University,16,0,3,3,0.19,14,-4
1259,Andrew Centrella (D),Providence College,18,0,3,3,0.17,0,5
1260,Conor Cole (C),University of Alaska-Anchorage,20,0,3,3,0.15,14,-7
1261,Joey Potter (D),Union College,21,0,3,3,0.14,4,-1
1262,Noah Ellis (D),University of Nebraska-Omaha,21,0,3,3,0.14,6,-5
1263,Owen Nolan (D),Army (U.S. Military Academy),21,0,3,3,0.14,16,-2
1264,Nolan Hayes (D),Northeastern University,22,0,3,3,0.14,0,-1
1265,Cole Crusberg-Roseen (D),Western Michigan University,22,0,3,3,0.14,10,6
1266,Oliver Moberg (RW),Clarkson University,24,0,3,3,0.13,2,-5
1267,Clint Levens (C),Providence College,24,0,3,3,0.13,31,-1
1268,Mason Reiners (D),St. Cloud State University,26,0,3,3,0.12,4,6
1269,Brenden Rons (D),Lindenwood University,27,0,3,3,0.11,18,-7
1270,Sean Vlasich (D),Army (U.S. Military Academy),28,0,3,3,0.11,6,-10
1271,Kevin Scott (D),RIT (Rochester Inst. of Tech.),29,0,3,3,0.10,19,3
1272,Will Arquiett (F),St. Lawrence University,30,0,3,3,0.10,12,-5
1273,Warren Clark (D),St. Cloud State University,31,0,3,3,0.10,8,-6
1274,Grant Anderson (D),Sacred Heart University,34,0,3,3,0.09,11,-5
1275,Devon Carlstrom (D),Stonehill College,35,0,3,3,0.09,10,-30
1276,Tobias Abrahamsson (D),University of St. Thomas,37,0,3,3,0.08,0,1
1277,Carson Peters (D),University of St. Thomas,37,0,3,3,0.08,22,0
1278,Brody Gagno (D),College of the Holy Cross,38,0,3,3,0.08,14,4
1279,Carl Fish (D),University of Minnesota,38,0,3,3,0.08,15,8
1280,Frankie Carogioiello (C),Miami University (Ohio),4,2,0,2,0.50,0,0
1281,Andrew Garby (D),Army (U.S. Military Academy),10,2,0,2,0.20,2,-3
1282,Brendan Dumas (F),Sacred Heart University,12,2,0,2,0.17,18,-2
1283,Kolby Amici (F),Bentley University,14,2,0,2,0.14,6,-2
1284,Nick Marciano (D),Princeton University,22,2,0,2,0.09,6,-5
1285,Chikara Hanzawa (RW),Sacred Heart University,28,2,0,2,0.07,6,-6
1286,Cameron Ricotta (LW),Mercyhurst University,5,1,1,2,0.40,0,2
1287,Patriks Marcinkevics (LW),Michigan Tech,5,1,1,2,0.40,4,-2
1288,Griffin Jurecki (LW),Michigan State University,6,1,1,2,0.33,0,0
1289,Michael Young (F),Princeton University,7,1,1,2,0.29,2,-1
1290,Owen Baker (RW),Michigan State University,7,1,1,2,0.29,15,0
1291,Jakub Lewandowski (F),Bemidji State University,9,1,1,2,0.22,4,-3
1292,Viktor Hurtig (D),Michigan State University,9,1,1,2,0.22,6,1
1293,Matthew Boczar (F),Robert Morris University,11,1,1,2,0.18,0,-3
1294,Jojo Tanaka-Campbell (F),Yale University,11,1,1,2,0.18,2,-4
1295,Adam Jeffery (LW),RIT (Rochester Inst. of Tech.),11,1,1,2,0.18,4,5
1296,Trevor Smith (C),Army (U.S. Military Academy),12,1,1,2,0.17,2,-13
1297,Beanie Richter (F),Yale University,14,1,1,2,0.14,0,-7
1298,Evan Orr (D),Michigan Tech,14,1,1,2,0.14,2,-1
1299,Jacob Marti (F),Air Force Academy,15,1,1,2,0.13,21,-3
1300,Dane Montgomery (D/RW),University of North Dakota,16,1,1,2,0.13,0,1
1301,Parker Lindauer (F),University of Maine,16,1,1,2,0.13,23,1
1302,Alexander Krause (F),Dartmouth College,18,1,1,2,0.11,15,0
1303,David Sacco (RW),Merrimack College,18,1,1,2,0.11,23,2
1304,Dominic Vidoli (D),University of Nebraska-Omaha,19,1,1,2,0.11,6,3
1305,Stephen Willey (LW),Army (U.S. Military Academy),20,1,1,2,0.10,0,-7
1306,Casey Aman (D),Penn State University,20,1,1,2,0.10,2,2
1307,Levi Stauber (F),Michigan Tech,20,1,1,2,0.10,4,1
1308,Nolan Fitzpatrick (F),Stonehill College,20,1,1,2,0.10,15,-7
1309,Teddy Lagerback (LW),Miami University (Ohio),22,1,1,2,0.09,12,-5
1310,Xavier Henry (D),University of Vermont,22,1,1,2,0.09,22,0
1311,Dylan Finlay (D),University of Alaska-Anchorage,23,1,1,2,0.09,4,-8
1312,Christian Gorscak (F),Niagara University,23,1,1,2,0.09,4,-2
1313,Oliver Flynn (C),University of Connecticut,23,1,1,2,0.09,6,-6
1314,Winter Wallace (RW),Cornell University,24,1,1,2,0.08,12,-2
1315,Nicholas Van Tassell (C),UMass,24,1,1,2,0.08,19,-4
1316,Talon Sigurdson (F),Clarkson University,25,1,1,2,0.08,10,-4
1317,Jack Lyons (D),Canisius College,26,1,1,2,0.08,10,-5
1318,Michael Fisher (D),Northeastern University,29,1,1,2,0.07,14,-9
1319,Chase Pletzke (C),University of Michigan,30,1,1,2,0.07,0,3
1320,Gentry Shamburger (F),Boston College,30,1,1,2,0.07,8,-4
1321,Lucas Matta (D),RPI (Rensselaer Polytech. Inst.),32,1,1,2,0.06,12,-12
1322,John Mittelstadt (F),University of Minnesota,33,1,1,2,0.06,6,0
1323,Stefan Owens (F),UMass-Lowell,34,1,1,2,0.06,2,-6
1324,Mick Frechette (D),Boston University,7,0,2,2,0.29,2,2
1325,Evan Miller (C),RIT (Rochester Inst. of Tech.),10,0,2,2,0.20,4,-1
1326,Brady Hunter (C),Merrimack College,11,0,2,2,0.18,2,-1
1327,Tanyon Bajzer (RW),Miami University (Ohio),13,0,2,2,0.15,0,-4
1328,Tyson Jugnauth (D),University of Wisconsin,13,0,2,2,0.15,8,-2
1329,Cade Alami (D),Arizona State University,14,0,2,2,0.14,16,-2
1330,Christian Sanda (F),UMass,15,0,2,2,0.13,4,-4
1331,Will Troutwine (D),College of the Holy Cross,18,0,2,2,0.11,2,5
1332,Girts Silkalns (F),UMass-Lowell,18,0,2,2,0.11,6,-3
1333,Tucker Ness (D),Arizona State University,18,0,2,2,0.11,60,1
1334,Cole Galata (F),Sacred Heart University,20,0,2,2,0.10,4,-8
1335,Will Svenddal (D),Augustana University,20,0,2,2,0.10,8,-4
1336,Tyler DesRochers (D),Mercyhurst University,21,0,2,2,0.10,10,-9
1337,Noah Wakeford (F),Brown University,23,0,2,2,0.09,8,-3
1338,Rylee Hlusiak (RW),Sacred Heart University,25,0,2,2,0.08,10,-6
1339,Brenden MacLaren (F),Ferris State University,27,0,2,2,0.07,11,-15
1340,Sean Kilcullen (D),UMass-Lowell,27,0,2,2,0.07,25,-9
1341,Carson Dyck (F),Penn State University,30,0,2,2,0.07,16,-7
1342,Jake Boltmann (D),University of Notre Dame,30,0,2,2,0.07,22,-2
1343,Karl Falk (D),St. Cloud State University,33,0,2,2,0.06,6,-7
1344,Liam Lesakowski (D),University of Maine,34,0,2,2,0.06,36,0
1345,Elliott McDermott (D),UMass,35,0,2,2,0.06,14,1
1346,Dylan Robbins (F),Sacred Heart University,35,0,2,2,0.06,16,-8
1347,Peter Muzyka (D),Long Island University,35,0,2,2,0.06,70,2
1348,Kasper VÃ¤hÃ¤rautio (D),Michigan Tech,37,0,2,2,0.05,12,5
1349,Nicolas Petruolo (D),College of the Holy Cross,37,0,2,2,0.05,39,6
1350,Roc Truman (F),UMass-Lowell,2,1,0,1,0.50,0,-1
1351,Tom Richter (F),Union College,2,1,0,1,0.50,0,1
1352,John Larkin (D),Ohio State University,3,1,0,1,0.33,2,2
1353,Filip Wiberg (C/W),University of Alaska-Fairbanks,3,1,0,1,0.33,4,0
1354,Ryder Donovan (C/RW),University of St. Thomas,3,1,0,1,0.33,4,2
1355,Cameron Recchi (C/LW),University of St. Thomas,5,1,0,1,0.20,2,-3
1356,Danny Weight (C),Colorado College,6,1,0,1,0.17,0,-2
1357,Shane LaVelle (F),Lindenwood University,7,1,0,1,0.14,2,0
1358,Christian MacDougall (F),Canisius College,7,1,0,1,0.14,4,0
1359,Jason Siedem (F),University of New Hampshire,8,1,0,1,0.13,0,-2
1360,Garrett Sundquist (D),Sacred Heart University,9,1,0,1,0.11,2,-3
1361,Wyatt Schlaht (F),Brown University,10,1,0,1,0.10,0,-2
1362,Andrew Amousse (C),American International College,10,1,0,1,0.10,4,-1
1363,Mario Gasparini (D),University of Vermont,11,1,0,1,0.09,4,-4
1364,Will Hilfiker (D),University of Alaska-Fairbanks,12,1,0,1,0.08,15,6
1365,Braden Doyle (D),Northeastern University,13,1,0,1,0.08,0,-3
1366,Matt Hubbarde (C),Providence College,13,1,0,1,0.08,2,3
1367,Ethan Harrison (F),Bentley University,13,1,0,1,0.08,2,2
1368,Ben Brunette (D),UMass-Lowell,13,1,0,1,0.08,4,1
1369,Ryan King (C/LW),Stonehill College,13,1,0,1,0.08,10,-6
1370,Daniel Sambuco (F),University of Vermont,13,1,0,1,0.08,12,-2
1371,Carter Rose (D),Clarkson University,15,1,0,1,0.07,4,0
1372,Adam Cardona (D),UMass-Lowell,15,1,0,1,0.07,8,1
1373,Kevin Anderson (F),Princeton University,17,1,0,1,0.06,4,-5
1374,Tyler Dunbar (D),Colorado College,17,1,0,1,0.06,8,1
1375,Noah Quinn (F),Bemidji State University,18,1,0,1,0.06,10,-3
1376,Jase Sofo (D),University of St. Thomas,18,1,0,1,0.06,14,-2
1377,Dean Bauchiero (W),Brown University,21,1,0,1,0.05,6,-8
1378,Tanner Rowe (F),University of Michigan,25,1,0,1,0.04,24,-3
1379,Trym LÃ¸kkeberg (C),Dartmouth College,31,1,0,1,0.03,8,-5
1380,Dominic James (C/LW),University of Minnesota-Duluth,2,0,1,1,0.50,0,0
1381,Bo Cosman (F),UMass,3,0,1,1,0.33,0,0
1382,Cole Burtch (LW),Western Michigan University,3,0,1,1,0.33,4,0
1383,Charlie Lurie (F),University of Nebraska-Omaha,4,0,1,1,0.25,2,0
1384,Derek Pys (D),University of Alaska-Fairbanks,4,0,1,1,0.25,17,1
1385,Jonathan Horn (F),UMass-Lowell,5,0,1,1,0.20,0,-1
1386,Anthony Mollica (D),St. Lawrence University,5,0,1,1,0.20,0,-2
1387,Brady Bjork (LW/RW),University of Notre Dame,5,0,1,1,0.20,2,1
1388,Timothy Heinke (RW),Quinnipiac University,6,0,1,1,0.17,0,1
1389,Jacob Napier (D),Western Michigan University,6,0,1,1,0.17,2,0
1390,Braidan Simmons-Fischer (D),University of St. Thomas,6,0,1,1,0.17,6,-1
1391,Cole Helm (F),Arizona State University,6,0,1,1,0.17,17,1
1392,Matthew Romer (F),Arizona State University,7,0,1,1,0.14,0,1
1393,Akseli Pennanen (F),American International College,7,0,1,1,0.14,0,-1
1394,Kyler Kovich (LW),Cornell University,7,0,1,1,0.14,2,1
1395,Jake Lammens (D),St. Lawrence University,7,0,1,1,0.14,4,-5
1396,Sean James (LW),Mercyhurst University,8,0,1,1,0.13,0,-1
1397,Kyle Aucoin (D),Harvard University,8,0,1,1,0.13,6,-4
1398,Heath Armstrong (F),Long Island University,9,0,1,1,0.11,0,5
1399,Rowan Miller (F),University of Alaska-Anchorage,10,0,1,1,0.10,4,-3
1400,Tucker Hartmann (D),Yale University,10,0,1,1,0.10,6,-1
1401,Shawn O'Donnell (F),UMass-Lowell,10,0,1,1,0.10,6,-1
1402,Matthew Brille (F),Brown University,11,0,1,1,0.09,0,-1
1403,Marian Mosko (D),Cornell University,11,0,1,1,0.09,0,3
1404,Max Ruoho (D),Niagara University,11,0,1,1,0.09,2,-5
1405,Max Osborne (D),University of Alaska-Anchorage,11,0,1,1,0.09,4,1
1406,Ben Anderson (F),University of Alaska-Anchorage,11,0,1,1,0.09,14,0
1407,A.J. Casperson (D),Long Island University,12,0,1,1,0.08,2,2
1408,Caden Lewandowski (D),Clarkson University,12,0,1,1,0.08,4,-2
1409,Nikita Borodayenko (F),Merrimack College,12,0,1,1,0.08,4,-1
1410,Ian Devlin (D),Princeton University,12,0,1,1,0.08,8,0
1411,Gabe Blanchard (D),UMass-Lowell,12,0,1,1,0.08,19,-1
1412,Tyler Young (RW),Merrimack College,12,0,1,1,0.08,25,-4
1413,Connor Welsh (F),College of the Holy Cross,13,0,1,1,0.08,4,1
1414,Cam Mitchell (LW),University of Nebraska-Omaha,13,0,1,1,0.08,4,0
1415,Tanner Main (D),Bentley University,13,0,1,1,0.08,10,-3
1416,Carter Belitski (F),University of Alaska-Anchorage,14,0,1,1,0.07,2,-1
1417,Alex Konovalov (F),Princeton University,14,0,1,1,0.07,2,-2
1418,Jake Ratzlaff (D),University of St. Thomas,14,0,1,1,0.07,2,-3
1419,Owen Simpson (D),University of Connecticut,14,0,1,1,0.07,4,2
1420,Charlie Spence (D),College of the Holy Cross,14,0,1,1,0.07,4,-3
1421,Jaedon Leslie (F),Niagara University,14,0,1,1,0.07,8,-7
1422,Eric Huss (F),Army (U.S. Military Academy),15,0,1,1,0.07,4,0
1423,Finn Brown (LW),RPI (Rensselaer Polytech. Inst.),16,0,1,1,0.06,0,-1
1424,Nicholas Kent (D),Mercyhurst University,16,0,1,1,0.06,4,-6
1425,Jakob Peterson (D),Northern Michigan University,18,0,1,1,0.06,2,-3
1426,Brady Egan (C),Clarkson University,18,0,1,1,0.06,2,-2
1427,Cam Collins (F),Stonehill College,18,0,1,1,0.06,2,-13
1428,Jordan Venegoni (F),Lake Superior State University,18,0,1,1,0.06,8,-3
1429,Christian Jimenez (D),Harvard University,18,0,1,1,0.06,12,-9
1430,Nate Benoit (D),University of North Dakota,19,0,1,1,0.05,4,-1
1431,Nicholas O'Hanisain (D),Bowling Green State University,20,0,1,1,0.05,9,-1
1432,Tyrell Boucher (D),Northern Michigan University,21,0,1,1,0.05,4,-4
1433,Ben Schultheis (D),Ferris State University,21,0,1,1,0.05,6,-8
1434,Nathan Sullivan (F),RPI (Rensselaer Polytech. Inst.),21,0,1,1,0.05,10,-10
1435,Thomas Gangl (D),Robert Morris University,22,0,1,1,0.05,6,4
1436,Jeff Hutchinson (D),Augustana University,22,0,1,1,0.05,6,0
1437,David Hejduk (D),Harvard University,22,0,1,1,0.05,8,-4
1438,Jack Blake (D),Bowling Green State University,23,0,1,1,0.04,4,-4
1439,Tyler Nasca (D),Mercyhurst University,24,0,1,1,0.04,6,-4
1440,Josh Waters (F),Dartmouth College,24,0,1,1,0.04,16,-4
1441,Jake Martin (D),Quinnipiac University,25,0,1,1,0.04,0,3
1442,Brendan Wang (D),Princeton University,25,0,1,1,0.04,8,-13
1443,Owen Forester (D),Yale University,25,0,1,1,0.04,38,-4
1444,Duncan Ramsay (D),University of Vermont,26,0,1,1,0.04,6,0
1445,Brayden Morrison (C/LW),Miami University (Ohio),26,0,1,1,0.04,6,-5
1446,Cam Knuble (F),Western Michigan University,28,0,1,1,0.04,4,0
1447,Kieran O'Hearn (D),Yale University,29,0,1,1,0.03,36,-10
1448,Trevor LeDonne (D),Robert Morris University,29,0,1,1,0.03,43,-2
1449,Caleb Huffman (D),University of Alaska-Anchorage,30,0,1,1,0.03,57,-7
1450,Andy Moore (F),Northeastern University,31,0,1,1,0.03,12,2
1451,Henry Nelson (D),University of Notre Dame,31,0,1,1,0.03,42,-2
1452,Eli Sebastian (C),Northeastern University,32,0,1,1,0.03,2,-12
1453,Mark D'Agostino (F),University of Connecticut,0,0,0,0,0.00,0,0
1454,Cameron Moger (D),Michigan Tech,0,0,0,0,0.00,0,0
1455,Tim Delay (RW),Boston College,0,0,0,0,0.00,0,0
1456,Paul Davey (LW),Boston College,0,0,0,0,0.00,0,0
1457,Jacob Conrad (D),Lake Superior State University,0,0,0,0,0.00,0,0
1458,Owen Fowler (LW),UMass-Lowell,0,0,0,0,0.00,0,0
1459,Niko Jovanovic (C/LW),University of Notre Dame,0,0,0,0,0.00,0,0
1460,Dayne Hoyord (F),Army (U.S. Military Academy),0,0,0,0,0.00,0,0
1461,Finlay Williams (F),University of Notre Dame,0,0,0,0,0.00,0,0
1462,Cole Teleki (D),Lindenwood University,0,0,0,0,0.00,0,0
1463,Ethan Wolthers (F),Western Michigan University,0,0,0,0,0.00,0,0
1464,Ethan Perrault (D),Augustana University,0,0,0,0,0.00,0,0
1465,Bauer Swift (D),University of Connecticut,0,0,0,0,0.00,0,0
1466,Jackson McCarthy (D),Mercyhurst University,0,0,0,0,0.00,0,0
1467,David Ma (D),Princeton University,0,0,0,0,0.00,0,0
1468,Eric DeDobbelaer (C/RW),UMass,0,0,0,0,0.00,0,0
1469,Carter Rapalje (F),Stonehill College,0,0,0,0,0.00,0,0
1470,Aidan Carney (F),University of Maine,0,0,0,0,0.00,0,0
1471,Nikolai Charchenko (D),Colorado College,0,0,0,0,0.00,0,0
1472,Mike Brown (D),Merrimack College,0,0,0,0,0.00,0,0
1473,Will Schimek (D),Providence College,0,0,0,0,0.00,0,0
1474,Garrett Szydlowski (RW),Western Michigan University,0,0,0,0,0.00,0,0
1475,Will Francis (D),University of Minnesota-Duluth,1,0,0,0,0.00,0,0
1476,Luke Strickland (LW),Long Island University,1,0,0,0,0.00,0,1
1477,Huston Karpman (F),University of Connecticut,1,0,0,0,0.00,0,-1
1478,Luke LaMaster (D),University of Wisconsin,1,0,0,0,0.00,0,0
1479,Hunter Weiss (D),University of Notre Dame,1,0,0,0,0.00,0,-1
1480,Thomas Jarman (D),Boston University,1,0,0,0,0.00,0,0
1481,Evan Mitchell (D),St. Lawrence University,1,0,0,0,0.00,0,0
1482,Mitch LaFay (C/W),University of Alaska-Anchorage,1,0,0,0,0.00,0,0
1483,Ronan Walsh (F),University of New Hampshire,1,0,0,0,0.00,0,0
1484,Harry Meirowitz (D),Brown University,1,0,0,0,0.00,0,0
1485,Oliver Bezick (D),Michigan Tech,1,0,0,0,0.00,0,-1
1486,Zach Hahn (D),University of New Hampshire,1,0,0,0,0.00,0,0
1487,William Elias (D),College of the Holy Cross,1,0,0,0,0.00,0,0
1488,Sam Jacobs (F),Air Force Academy,1,0,0,0,0.00,0,0
1489,Kennedy O'Connor (D),UMass,1,0,0,0,0.00,0,0
1490,Peter Frates (D),Harvard University,1,0,0,0,0.00,0,0
1491,Matteo Pecchia (LW),University of Alaska-Fairbanks,1,0,0,0,0.00,2,-1
1492,Josh Bohlin (F),Army (U.S. Military Academy),1,0,0,0,0.00,2,-1
1493,Eli Pilosof (C),Union College,1,0,0,0,0.00,2,0
1494,Joey Dosan (F),Army (U.S. Military Academy),2,0,0,0,0.00,0,-1
1495,Ryan Stevens (F),Yale University,2,0,0,0,0.00,0,-2
1496,Nicky Wallace (D),Quinnipiac University,2,0,0,0,0.00,0,1
1497,Antonio Fernandez (D),Colorado College,2,0,0,0,0.00,0,0
1498,David Hymovitch (F),Arizona State University,2,0,0,0,0.00,0,0
1499,Jeremy Gervais (D),Lake Superior State University,2,0,0,0,0.00,0,-1
1500,Jake Sacratini (RW),American International College,2,0,0,0,0.00,0,0
1501,Jasper Lester (D),Air Force Academy,2,0,0,0,0.00,0,1
1502,Cooper Connell (F),Bentley University,2,0,0,0,0.00,0,0
1503,James Callahan (D),Air Force Academy,2,0,0,0,0.00,0,0
1504,Edvards Bergmanis (F),University of Alaska-Fairbanks,2,0,0,0,0.00,0,0
1505,Gavin Best (F),Michigan State University,2,0,0,0,0.00,0,-2
1506,Trevor Kukkonen (F),Michigan Tech,2,0,0,0,0.00,2,0
1507,Josh Phillips (D),Union College,2,0,0,0,0.00,2,0
1508,Aidan Connolly (C),Sacred Heart University,2,0,0,0,0.00,2,-2
1509,Danny Pearson (F),Bentley University,2,0,0,0,0.00,4,-1
1510,Anthony Messuri (F),Northeastern University,3,0,0,0,0.00,0,-1
1511,Lee Chiang (F),Robert Morris University,3,0,0,0,0.00,0,-1
1512,Seiya Tanaka-Campbell (F),Yale University,3,0,0,0,0.00,0,0
1513,Jaryd Sych (D),Mercyhurst University,3,0,0,0,0.00,0,-1
1514,Dylan Davies (D/F),RPI (Rensselaer Polytech. Inst.),3,0,0,0,0.00,2,0
1515,Matt Hutton (F),Robert Morris University,3,0,0,0,0.00,2,-1
1516,Tanner Komzak (D),University of North Dakota,4,0,0,0,0.00,0,2
1517,Nolan Joyce (D),Boston College,4,0,0,0,0.00,0,2
1518,Chase Ramsay (D),Quinnipiac University,4,0,0,0,0.00,0,-1
1519,Jack Powell (D),Bemidji State University,4,0,0,0,0.00,0,1
1520,Jack Shemligian (D),Stonehill College,4,0,0,0,0.00,2,-4
1521,Benito Posa (F),Lake Superior State University,4,0,0,0,0.00,2,-4
1522,Michael Martignetti (D),Stonehill College,4,0,0,0,0.00,4,-5
1523,Jacob Badal (LW),Ferris State University,5,0,0,0,0.00,0,-3
1524,James Crossman (D),Michigan State University,5,0,0,0,0.00,0,0
1525,Isaac MacLeod (RW),St. Lawrence University,5,0,0,0,0.00,2,-1
1526,Davis Fry (F),Mercyhurst University,5,0,0,0,0.00,2,-2
1527,Noah Serdachny (F),Colorado College,5,0,0,0,0.00,2,-2
1528,Tanner Edwards (LW/C),Minnesota State University (Mankato),5,0,0,0,0.00,4,-1
1529,Kaleb Tiessen (D),St. Cloud State University,6,0,0,0,0.00,0,1
1530,Brendan Miles (D),University of Michigan,6,0,0,0,0.00,0,-1
1531,Michael Emerson (RW),University of North Dakota,6,0,0,0,0.00,2,-1
1532,Lucas Jones (D),University of Vermont,6,0,0,0,0.00,17,-2
1533,Charlie Russell (F),Clarkson University,7,0,0,0,0.00,0,-4
1534,Brendan Poshak (F),Northern Michigan University,7,0,0,0,0.00,0,1
1535,Atte Lehikoinen (D),Long Island University,7,0,0,0,0.00,2,-3
1536,Keegan Langefels (D),Canisius College,7,0,0,0,0.00,2,-4
1537,Joshua Orrico (D),University of Michigan,7,0,0,0,0.00,2,0
1538,Sam Stange (RW),University of Wisconsin,7,0,0,0,0.00,4,-2
1539,Douglas Andersson (LW),American International College,7,0,0,0,0.00,6,-3
1540,Doug Scott (D),RIT (Rochester Inst. of Tech.),7,0,0,0,0.00,14,-1
1541,Ethan Ullrick (F),Air Force Academy,7,0,0,0,0.00,15,-3
1542,John Dalton (D),University of Maine,8,0,0,0,0.00,0,-2
1543,Kade Nielsen (F),Minnesota State University (Mankato),8,0,0,0,0.00,0,-4
1544,Tristan Amonte (F),Boston University,8,0,0,0,0.00,0,0
1545,Jeppe Urup Mogensen (D),Northern Michigan University,8,0,0,0,0.00,2,-3
1546,Will Traeger (C),Boston College,8,0,0,0,0.00,2,-1
1547,Tyler Gaulin (F),Mercyhurst University,8,0,0,0,0.00,8,-4
1548,Jack O'Brien (D),Cornell University,9,0,0,0,0.00,0,4
1549,Spencer Evans (D),Brown University,9,0,0,0,0.00,0,0
1550,Charles Merkley (RW),Robert Morris University,9,0,0,0,0.00,0,-3
1551,Daniel Baldassarra (C),Long Island University,9,0,0,0,0.00,4,-2
1552,Kade Peterson (F),Long Island University,9,0,0,0,0.00,4,-2
1553,Ryan Helliwell (D),University of Notre Dame,9,0,0,0,0.00,17,0
1554,Sean Donaldson (LW),Cornell University,10,0,0,0,0.00,0,-1
1555,Trevor Bishop (F),Western Michigan University,10,0,0,0,0.00,0,-3
1556,Ean Somoza (F),Western Michigan University,10,0,0,0,0.00,12,-1
1557,Jake Veilleux (D/F),University of Connecticut,11,0,0,0,0.00,0,0
1558,Spencer Schneider (F),Bowling Green State University,12,0,0,0,0.00,0,-3
1559,Thomas Haynes (D),Robert Morris University,12,0,0,0,0.00,4,-5
1560,Owen Neuharth (C),Colgate University,12,0,0,0,0.00,4,0
1561,Darwin Lakoduk (F),American International College,12,0,0,0,0.00,4,-2
1562,Luke Khozozian (F),Harvard University,12,0,0,0,0.00,19,-1
1563,Axel Begley (D),University of Minnesota,14,0,0,0,0.00,0,-2
1564,Luke Erickson (D),St. Lawrence University,14,0,0,0,0.00,10,-4
1565,Jacob Felker (F),Army (U.S. Military Academy),14,0,0,0,0.00,19,-7
1566,Brendan Budy (LW),RPI (Rensselaer Polytech. Inst.),15,0,0,0,0.00,8,-5
1567,Michael Outzen (F),Northeastern University,16,0,0,0,0.00,2,0
1568,Patrick Dawson (D),Northeastern University,16,0,0,0,0.00,2,-4
1569,Hunter Andrew (F),Canisius College,16,0,0,0,0.00,4,-8
1570,Brian Silver (D),Augustana University,16,0,0,0,0.00,8,-7
1571,Brady Cleveland (D),University of Wisconsin,16,0,0,0,0.00,19,-3
1572,Lynden Grandberg (F),Brown University,18,0,0,0,0.00,0,-4
1573,Cameron Mannion (D),Stonehill College,18,0,0,0,0.00,8,-19
1574,Jon Bell (D),Army (U.S. Military Academy),18,0,0,0,0.00,15,-4
1575,Nico DeVita (D),Ferris State University,19,0,0,0,0.00,2,-16
1576,Bodie Nobes (D),University of Maine,19,0,0,0,0.00,17,-1
1577,Max Rud (D),University of Minnesota,20,0,0,0,0.00,0,-1
1578,Carter Schade (D),Penn State University,21,0,0,0,0.00,15,-9
1579,Jack Pascucci (D),University of Connecticut,24,0,0,0,0.00,6,-8
1580,Matthew Cassidy (RW),Ohio State University,24,0,0,0,0.00,24,-5
1581,Gavin Puskar (F),Brown University,26,0,0,0,0.00,6,-4
1582,Mackenzie Merriman (F),Princeton University,27,0,0,0,0.00,2,-15
1583,Tommy Lyons (F),Harvard University,29,0,0,0,0.00,2,-11
1584,Andrew Gilbert (D),Army (U.S. Military Academy),33,0,0,0,0.00,10,-12
1585,Hunter Hastings (F),Stonehill College,34,0,0,0,0.00,18,-20
1586,Jimmy Rayhill (D),Cornell University,0,0,0,0,0.00,0,0
1587,Jack Page (D),Boston University,0,0,0,0,0.00,0,0
1588,P.J. Garrett (D),Colgate University,0,0,0,0,0.00,0,0
1589,Aaron Myers (F),Bemidji State University,0,0,0,0,0.00,0,0
1590,Peter Lajoy (F),University of Denver,0,0,0,0,0.00,0,0
1591,Liam Cavan (D),Merrimack College,0,0,0,0,0.00,0,0
1592,Steven Kesslering (F),Niagara University,0,0,0,0,0.00,0,0
1593,Kyle Furey (D),Northeastern University,0,0,0,0,0.00,0,0
1594,Liam Steele (D),Cornell University,0,0,0,0,0.00,0,0
1595,Nick Michel (F),University of Minnesota,0,0,0,0,0.00,0,0
1596,Hunter McCurdy (D),American International College,0,0,0,0,0.00,0,0
1597,Brady MacDonald (D),Dartmouth College,0,0,0,0,0.00,0,0
1598,Nick Grimaldi (F),Ferris State University,0,0,0,0,0.00,0,0
1599,Luke Kron (C),University of St. Thomas,0,0,0,0,0.00,0,0
1600,Ben Schoen (C),Penn State University,0,0,0,0,0.00,0,0
