ID,Player,Team,GP,G,A,TP,PPG,PIM,PM
1,Adam Fantilli (C),University of Michigan,36,30,35,65,1.81,67,31
2,Logan Cooley (C/LW),University of Minnesota,39,22,38,60,1.54,42,38
3,Collin Graf (RW/C),Quinnipiac University,41,21,38,59,1.44,4,31
4,Sean Farrell (C/LW),Harvard University,34,20,33,53,1.56,12,21
5,Jimmy Snuggerud (RW),University of Minnesota,40,21,29,50,1.25,42,35
6,Ryan McAllister (C),Western Michigan University,39,13,36,49,1.26,14,21
7,Lane Hutson (D),Boston University,39,15,33,48,1.23,26,25
8,Luke Hughes (D),University of Michigan,39,10,38,48,1.23,26,24
9,Jason Polin (RW),Western Michigan University,39,30,17,47,1.21,13,26
10,Matt Brown (LW/RW),Boston University,39,16,31,47,1.21,6,15
11,Massimo Rizzo (C),University of Denver,38,17,29,46,1.21,14,24
12,Austen Swankler (C),Bowling Green State University,35,19,25,44,1.26,43,13
13,Frank Ireland (F),Stonehill College,25,17,27,44,1.76,38,17
14,Mackie Samoskevich (RW/C),University of Michigan,39,20,23,43,1.10,28,5
15,Sam Lipkin (LW/C),Quinnipiac University,39,14,29,43,1.10,14,33
16,Alex Laferriere (RW/LW),Harvard University,34,21,21,42,1.24,20,13
17,Matthew Knies (LW/RW),University of Minnesota,40,21,21,42,1.05,29,31
18,Jackson Blake (RW/C),University of North Dakota,39,16,26,42,1.08,16,-1
19,Max Sasson (C/W),Western Michigan University,38,15,27,42,1.11,18,20
20,Robert Mastrosimone (LW/C),Arizona State University,38,11,31,42,1.11,31,4
21,Alex Jefferies (LW),Merrimack College,38,14,27,41,1.08,16,9
22,Stephen Halliday (C),Ohio State University,40,9,32,41,1.03,19,7
23,Jami Krannila (C),St. Cloud State University,41,21,19,40,0.98,43,23
24,Ethan De Jong (RW/LW),Quinnipiac University,41,19,21,40,0.98,8,25
25,Carter Wilkie (RW),RIT (Rochester Inst. of Tech.),39,14,26,40,1.03,78,9
26,David Silye (C/RW),Minnesota State University (Mankato),39,23,16,39,1.00,25,2
27,Alex Young (C/W),Colgate University,40,21,18,39,0.98,37,1
28,Rutger McGroarty (C/W),University of Michigan,39,18,21,39,1.00,18,15
29,Jake Wise (C/LW),Ohio State University,40,12,27,39,0.98,10,5
30,Grant Cruikshank (C/LW),St. Cloud State University,41,23,15,38,0.93,16,5
31,Aidan McDonough (LW/RW),Northeastern University,34,20,18,38,1.12,14,14
32,Jacob Quillan (C/LW),Quinnipiac University,41,19,19,38,0.93,12,37
33,Josh Doan (RW/LW),Arizona State University,39,16,22,38,0.97,18,-2
34,Andre Ghantous (RW/LW),Northern Michigan University,38,13,25,38,1.00,32,4
35,Gavin Brindley (RW/LW),University of Michigan,41,12,26,38,0.93,22,21
36,Ayrton Martino (LW),Clarkson University,37,9,29,38,1.03,30,14
37,Carter Mazur (LW),University of Denver,40,22,15,37,0.93,32,19
38,Riese Gaber (RW/LW),University of North Dakota,39,20,17,37,0.95,31,-4
39,Anthony Vincent (RW/C),Long Island University,36,17,20,37,1.03,78,0
40,Cutter Gauthier (LW/C),Boston College,32,16,21,37,1.16,37,2
41,Zach Metsa (D),Quinnipiac University,40,9,28,37,0.93,12,34
42,Lynden Breen (C/LW),University of Maine,36,21,15,36,1.00,22,10
43,Matt Coronato (RW/LW),Harvard University,34,20,16,36,1.06,14,24
44,Zachary Okabe (RW),St. Cloud State University,41,18,18,36,0.88,24,16
45,Keaton Mastrodonato (RW/C),Canisius College,42,16,20,36,0.86,30,-4
46,Justin Hryckowian (C/LW),Northeastern University,35,15,21,36,1.03,26,21
47,T.J. Hughes (F),University of Michigan,39,13,23,36,0.92,10,6
48,Veeti Miettinen (RW),St. Cloud State University,41,12,24,36,0.88,0,9
49,Blake Bennett (LW/RW),American International College,38,22,13,35,0.92,35,0
50,Carter Rapalje (F),Stonehill College,23,20,15,35,1.52,0,13
51,Ryan Miotto (F),Canisius College,42,17,18,35,0.83,29,6
52,Matthew Verboon (RW/C),Colgate University,40,16,19,35,0.88,23,-3
53,Jackson LaCombe (D),University of Minnesota,37,9,26,35,0.95,13,12
54,Jake Livingstone (D),Minnesota State University (Mankato),39,8,27,35,0.90,30,10
55,Jack Randl (LW),University of Nebraska-Omaha,37,18,16,34,0.92,22,13
56,Adam Goodsir (F),Long Island University,35,15,19,34,0.97,64,-11
57,Nikita Nesterenko (C/LW),Boston College,36,13,21,34,0.94,18,6
58,Mike Benning (D),University of Denver,39,13,21,34,0.87,38,24
59,Casey Dornbach (C/W),University of Denver,40,13,21,34,0.85,29,11
60,Cruz Lucius (RW),University of Wisconsin,34,11,23,34,1.00,18,-7
61,Matthew Wood (LW/C),University of Connecticut,35,11,23,34,0.97,4,7
62,Nicolas Müller (C/RW),Michigan State University,38,9,25,34,0.89,16,4
63,Mathieu Gosselin (RW/LW),Clarkson University,37,14,19,33,0.89,23,7
64,Max Itagaki (F),Army (U.S. Military Academy),37,4,29,33,0.89,28,-13
65,Chris Jandric (D),University of North Dakota,39,4,29,33,0.85,30,16
66,Dylan Duke (LW/C),University of Michigan,41,18,14,32,0.78,43,10
67,Eric Esposito (LW),Mercyhurst University,35,17,15,32,0.91,14,-1
68,Jack Ricketts (C),College of the Holy Cross,41,16,16,32,0.78,32,-1
69,Gianfranco Cassaro (D),RIT (Rochester Inst. of Tech.),39,14,18,32,0.82,42,19
70,Skyler Brind'Amour (C/LW),Quinnipiac University,41,14,18,32,0.78,27,25
71,A.J. Vanderbeck (RW),Northern Michigan University,35,13,19,32,0.91,33,-5
72,Luke Grainger (RW/C),Western Michigan University,38,12,20,32,0.84,12,18
73,Hudson Schandor (C),University of Connecticut,35,11,21,32,0.91,8,10
74,Artem Shlaine (C),Northern Michigan University,38,11,21,32,0.84,18,6
75,Dean Schwenninger (C),Stonehill College,23,10,22,32,1.39,52,10
76,Aidan Thompson (C/LW),University of Denver,32,10,22,32,1.00,4,15
77,Jeremy Wilmer (LW),Boston University,37,9,23,32,0.86,16,4
78,Jay O'Brien (C),Boston University,39,8,24,32,0.82,42,-1
79,Cade Mason (D),Long Island University,26,7,25,32,1.23,8,8
80,Mason Lohrei (D),Ohio State University,40,4,28,32,0.80,26,-3
81,Aiden Hansen-Bukata (D),RIT (Rochester Inst. of Tech.),37,2,30,32,0.86,24,19
82,Bryce Brodzinski (RW),University of Minnesota,40,19,12,31,0.78,12,15
83,Kevin Wall (RW),Penn State University,39,17,14,31,0.79,16,20
84,Wilmer Skoog (C),Boston University,37,16,15,31,0.84,28,13
85,Jack Devine (RW),University of Denver,38,14,17,31,0.82,19,18
86,Lleyton Roed (LW),Bemidji State University,36,13,18,31,0.86,6,-1
87,Ryland Mosley (LW/RW),Michigan Tech,39,12,19,31,0.79,13,5
88,Chase Gresock (F),Bowling Green State University,36,11,20,31,0.86,12,4
89,Jordan Biro (C),American International College,38,11,20,31,0.82,2,-3
90,Casey Carreau (C),Niagara University,40,10,21,31,0.78,16,2
91,Scott Morrow (D),UMass,35,9,22,31,0.89,16,-3
92,Domenick Fensore (D),Boston University,37,9,22,31,0.84,30,13
93,Ryan Greene (C),Boston University,38,9,22,31,0.82,20,18
94,Henry Thrun (D),Harvard University,33,7,24,31,0.94,14,20
95,Ryan Tverberg (C/RW),University of Connecticut,35,15,15,30,0.86,34,0
96,Neil Shea (LW),Sacred Heart University,37,14,16,30,0.81,12,1
97,David Gagnon (LW),Lindenwood University,30,13,17,30,1.00,16,-6
98,Mathieu De St. Phalle (RW/LW),University of Wisconsin,36,13,17,30,0.83,20,-11
99,Ryan O'Hara (LW),Bowling Green State University,36,11,19,30,0.83,25,9
100,Gunnarwolfe Fontaine (LW/C),Northeastern University,35,10,20,30,0.86,8,2
101,Daniel Russell (C),Michigan State University,38,8,22,30,0.79,29,8
102,Gabriel Seger (LW/C),Cornell University,30,7,23,30,1.00,19,5
103,Nathan Burke (C/LW),Bowling Green State University,36,17,12,29,0.81,12,7
104,Christian Fitzgerald (F),Minnesota State University (Mankato),38,16,13,29,0.76,16,9
105,Ian Murphy (RW/C),Princeton University,31,15,14,29,0.94,14,1
106,Matt Copponi (C),Merrimack College,37,14,15,29,0.78,30,8
107,Ryan Sandelin (RW/C),Minnesota State University (Mankato),38,14,15,29,0.76,33,3
108,Hunter Johannes (LW),Lindenwood University,28,13,16,29,1.04,87,12
109,Trevor Kuntar (C/LW),Boston College,34,13,16,29,0.85,36,5
110,Ture Linden (C),Penn State University,39,11,18,29,0.74,11,7
111,Zak Galambos (D),Western Michigan University,39,11,18,29,0.74,34,30
112,Andre Gasseau (C/LW),Boston College,36,10,19,29,0.81,14,6
113,Seamus Casey (D),University of Michigan,37,8,21,29,0.78,9,16
114,Mike Koster (D),University of Minnesota,40,6,23,29,0.73,8,13
115,Anthony Firriolo (D),Army (U.S. Military Academy),36,5,24,29,0.81,18,-10
116,Nick Anderson (D),Colgate University,40,3,26,29,0.73,39,7
117,Ben Steeves (LW),University of Minnesota-Duluth,35,21,7,28,0.80,36,-11
118,Joey Baez (F),Army (U.S. Military Academy),37,21,7,28,0.76,12,-15
119,Hunter McKown (C/RW),Colorado College,38,21,7,28,0.74,30,-19
120,Quinn Hutson (RW),Boston University,39,15,13,28,0.72,24,14
121,Ryan Cox (F),Niagara University,40,14,14,28,0.70,38,-7
122,Joe Miller (C),Harvard University,33,13,15,28,0.85,6,27
123,Cody Laskosky (C),RIT (Rochester Inst. of Tech.),37,13,15,28,0.76,83,18
124,Ben Berard (LW),Cornell University,34,11,17,28,0.82,8,3
125,John Keranen (F),Army (U.S. Military Academy),36,11,17,28,0.78,40,-9
126,Colton Young (LW),Colgate University,40,11,17,28,0.70,35,3
127,Jonny Sorenson (F),University of Alaska-Fairbanks,34,10,18,28,0.82,19,14
128,Dominic James (C/LW),University of Minnesota-Duluth,35,10,18,28,0.80,20,-6
129,Shane Ott (F),Niagara University,40,10,18,28,0.70,6,-7
130,Tristan Broz (C/LW),University of Denver,40,10,18,28,0.70,35,17
131,Payton Matsui (F),University of Alaska-Fairbanks,34,9,19,28,0.82,6,13
132,Brendan Furry (LW/RW),Minnesota State University (Mankato),39,9,19,28,0.72,15,9
133,Austin Magera (C),Sacred Heart University,37,8,20,28,0.76,26,6
134,Elias Rosén (D),Bemidji State University,36,4,24,28,0.78,18,1
135,Kyle Kukkonen (C/RW),Michigan Tech,39,18,9,27,0.69,18,1
136,Justin Pearson (LW),University of Connecticut,35,13,14,27,0.77,29,1
137,Joey Larson (RW/LW),Northern Michigan University,36,13,14,27,0.75,14,-1
138,Carl Berglund (C/LW),UMass-Lowell,36,12,15,27,0.75,12,7
139,Connor MacEachern (C),Penn State University,39,12,15,27,0.69,30,10
140,Tate Singleton (C),Ohio State University,40,11,16,27,0.68,50,12
141,Luc Salem (D),St. Lawrence University,36,10,17,27,0.75,28,12
142,Karsen Dorwart (LW/C),Michigan State University,38,10,17,27,0.71,8,10
143,Jaxon Nelson (C/RW),University of Minnesota,40,10,17,27,0.68,10,10
144,Ross Mitton (RW/LW),Colgate University,40,9,18,27,0.68,10,1
145,Patriks Marcinkevics (LW),Long Island University,24,6,21,27,1.13,23,5
146,Tyler Weiss (LW/C),University of Nebraska-Omaha,37,6,21,27,0.73,26,6
147,Brock Faber (D),University of Minnesota,38,4,23,27,0.71,12,29
148,Akito Hirose (D),Minnesota State University (Mankato),38,4,23,27,0.71,18,10
149,Mack Byers (LW),University of St. Thomas,36,18,8,26,0.72,6,4
150,Alexander Campbell (LW/C),Clarkson University,34,14,12,26,0.76,8,1
151,Ben Brar (LW),Merrimack College,38,14,12,26,0.68,39,10
152,Parker Ford (C/RW),Providence College,37,12,14,26,0.70,22,18
153,Willie Reim (F),Air Force Academy,36,11,15,26,0.72,34,-8
154,Kristóf Papp (C),Northern Michigan University,38,11,15,26,0.68,21,-4
155,Alex DiPaolo (LW),Colgate University,40,11,15,26,0.65,24,0
156,Kenny Connors (C),UMass,32,9,17,26,0.81,8,0
157,Ben Poisson (F),University of Maine,36,9,17,26,0.72,27,7
158,Ryan Naumovski (F),Niagara University,40,9,17,26,0.65,10,-2
159,Sam Malinski (D),Cornell University,34,8,18,26,0.76,29,10
160,Jonny Tychonick (D),University of Nebraska-Omaha,35,8,18,26,0.74,24,8
161,Liam McLinskey (RW/LW),College of the Holy Cross,40,21,4,25,0.63,22,0
162,David Keefer (RW),Northern Michigan University,38,15,10,25,0.66,8,-8
163,Matt Miller (RW),University of Nebraska-Omaha,34,13,12,25,0.74,32,11
164,Ty Mueller (C),University of Nebraska-Omaha,34,12,13,25,0.74,4,9
165,Rhett Pitlick (LW/RW),University of Minnesota,40,11,14,25,0.63,18,17
166,Matthew Barbolini (C/LW),Miami University (Ohio),34,10,15,25,0.74,42,-11
167,Kyler Kupka (F),St. Cloud State University,35,10,15,25,0.71,10,-1
168,Ottoville Leppänen (F),Merrimack College,38,6,19,25,0.66,10,6
169,Dylan Anhorn (D),St. Cloud State University,23,5,20,25,1.09,12,15
170,Andy Carroll (D),Minnesota State University (Mankato),39,5,20,25,0.64,6,4
171,David Melaragni (D),Canisius College,41,4,21,25,0.61,24,1
172,Ricky Lyle (LW),Army (U.S. Military Academy),37,13,11,24,0.65,43,1
173,Jagger Joshua (LW/RW),Michigan State University,37,13,11,24,0.65,92,0
174,Carter Randklev (F),Niagara University,38,13,11,24,0.63,16,-3
175,Liam Gorman (C),Princeton University,32,12,12,24,0.75,33,2
176,Liam Devlin (F),University of New Hampshire,35,12,12,24,0.69,18,-13
177,Kevin Lombardi (RW/LW),Sacred Heart University,36,12,12,24,0.67,23,6
178,Taylor Schneider (LW),Bowling Green State University,36,11,13,24,0.67,12,3
179,Louis Boudon (C),Lake Superior State University,36,10,14,24,0.67,18,-6
180,Brett Berard (LW),Providence College,36,10,14,24,0.67,35,5
181,Brett Abdelnour (LW),Army (U.S. Military Academy),37,10,14,24,0.65,20,-10
182,Cameron Berg (C/LW),University of Nebraska-Omaha,37,10,14,24,0.65,38,-5
183,Dustin Manz (C/RW),American International College,39,10,14,24,0.62,17,-2
184,Albin Nilsson (C),Niagara University,40,10,14,24,0.60,49,5
185,Sam Colangelo (RW/C),Northeastern University,35,9,15,24,0.69,12,-4
186,Connor McMenamin (LW),Penn State University,37,9,15,24,0.65,14,6
187,Ryan Ufko (D),UMass,32,8,16,24,0.75,25,-12
188,Marcus Joughin (F),Sacred Heart University,35,8,16,24,0.69,12,-1
189,Quinn Olson (LW/C),University of Minnesota-Duluth,37,7,17,24,0.65,32,-4
190,Brandon Koch (D),Air Force Academy,36,6,18,24,0.67,36,-7
191,Cole Gallant (C),Western Michigan University,39,6,18,24,0.62,4,17
192,Maxwell Crozier (D),Providence College,37,3,21,24,0.65,33,10
193,Jack Peart (D),St. Cloud State University,39,3,21,24,0.62,24,14
194,Andrew Lucas (D),University of Connecticut,35,2,22,24,0.69,6,3
195,William Tripp (D),Stonehill College,25,1,23,24,0.96,14,17
196,Brady Risk (RW/LW),University of Alaska-Fairbanks,33,13,10,23,0.70,22,10
197,Kobe Walker (RW),RIT (Rochester Inst. of Tech.),31,12,11,23,0.74,6,6
198,Brock Caufield (RW),University of Wisconsin,36,11,12,23,0.64,4,-12
199,Carter King (C/LW),University of Denver,38,11,12,23,0.61,6,3
200,Mason Nevers (C),University of Minnesota,40,10,13,23,0.58,2,15
201,Devin Kaplan (RW),Boston University,40,10,13,23,0.58,49,15
202,Andy Willis (F),Lindenwood University,26,8,15,23,0.88,12,8
203,Corson Ceulemans (D),University of Wisconsin,33,8,15,23,0.70,38,-5
204,Chayse Primeau (W/C),University of Notre Dame,37,8,15,23,0.62,18,-1
205,Adam Ingram (C),St. Cloud State University,41,8,15,23,0.56,20,0
206,Luke Rowe (D),Air Force Academy,33,7,16,23,0.70,37,-10
207,Cameron Lund (C/W),Northeastern University,35,7,16,23,0.66,16,1
208,Alex Barber (F),Bowling Green State University,36,7,16,23,0.64,34,-1
209,Matthew Guerra (F),College of the Holy Cross,41,7,16,23,0.56,28,-10
210,Brian Kramer (D),American International College,35,6,17,23,0.66,38,3
211,Noah Beck (D),Clarkson University,37,6,17,23,0.62,18,9
212,Ty Jackson (C),Arizona State University,38,6,17,23,0.61,17,-10
213,Carter Berger (D),Western Michigan University,33,5,18,23,0.70,16,14
214,Wyatt Kaiser (D),University of Minnesota-Duluth,35,5,18,23,0.66,48,5
215,John Prokop (D),Union College,35,4,19,23,0.66,20,-9
216,Jacob Bengtsson (D),Lake Superior State University,36,1,22,23,0.64,26,-7
217,Ryan Mahshie (F),RPI (Rensselaer Polytech. Inst.),31,15,7,22,0.71,6,0
218,Ross Armour (C/RW),Bemidji State University,32,14,8,22,0.69,30,1
219,Joseph Dunlap (RW/C),Ohio State University,40,13,9,22,0.55,41,3
220,Max Helgeson (F),University of Alaska-Anchorage,28,11,11,22,0.79,18,-2
221,Nick Cardelli (C/RW),American International College,31,11,11,22,0.71,12,14
222,Chase Dubois (F),University of Alaska-Fairbanks,34,11,11,22,0.65,6,9
223,Will Gavin (LW/C),Air Force Academy,35,11,11,22,0.63,27,-15
224,Noah Laba (C),Colorado College,35,11,11,22,0.63,48,-18
225,Todd Goehring (F),Sacred Heart University,37,11,11,22,0.59,6,-17
226,Logan Pietila (RW/C),Michigan Tech,39,11,11,22,0.56,10,7
227,T.J. Friedmann (W/C),Quinnipiac University,41,11,11,22,0.54,22,15
228,Jakob Lee (C),RPI (Rensselaer Polytech. Inst.),28,10,12,22,0.79,61,-1
229,Michael Lombardi (C/LW),Quinnipiac University,41,10,12,22,0.54,16,9
230,Jacob Schmidt-Svejstrup (RW),Clarkson University,37,9,13,22,0.59,56,11
231,Jason Pineo (C),Niagara University,40,9,13,22,0.55,33,-7
232,Reed Lebster (RW),UMass,30,8,14,22,0.73,6,-7
233,Nicholas Niemo (F),Bentley University,32,8,14,22,0.69,33,7
234,Cristophe Tellier (LW/C),Quinnipiac University,37,8,14,22,0.59,6,9
235,Trevor Janicke (RW/C),University of Notre Dame,37,8,14,22,0.59,12,1
236,Julius Janhonen (C),American International College,38,8,14,22,0.58,24,1
237,Dylan Wendt (RW/C),Western Michigan University,39,8,14,22,0.56,4,2
238,Sutter Muzzatti (F),RPI (Rensselaer Polytech. Inst.),35,7,15,22,0.63,42,-3
239,Maxim Andreev (C/LW),Cornell University,31,6,16,22,0.71,24,11
240,Eamon Powell (D),Boston College,36,5,17,22,0.61,16,7
241,Tanner Palocsik (D),Dartmouth College,30,4,18,22,0.73,22,-13
242,Joshua Eernisse (F),University of St. Thomas,36,14,7,21,0.58,54,-3
243,Davis Burnside (F),Ohio State University,40,14,7,21,0.53,26,6
244,Jason Brancheau (F),Ferris State University,35,13,8,21,0.60,14,-3
245,Dylan Jackson (RW),Arizona State University,37,12,9,21,0.57,27,-10
246,Colby Ambrosio (C/RW),Boston College,36,10,11,21,0.58,16,-2
247,Luc Laylin (F),University of St. Thomas,36,10,11,21,0.58,29,-12
248,Jeremy Davidson (RW),Michigan State University,38,10,11,21,0.55,20,0
249,Dalton Bancroft (RW/LW),Cornell University,33,9,12,21,0.64,19,9
250,Lukas Sillinger (W/C),Arizona State University,33,9,12,21,0.64,20,-9
251,Cole McWard (D),Ohio State University,39,9,12,21,0.54,8,-5
252,Travis Treloar (C),Ohio State University,35,8,13,21,0.60,14,-12
253,Randy Hernández (RW),Canisius College,40,8,13,21,0.53,6,-4
254,Cal Kiefiuk (F),UMass,31,7,14,21,0.68,29,-8
255,Pito Walton (D),Princeton University,32,7,14,21,0.66,12,-9
256,Alexander Malinowski (LW/RW),American International College,34,7,14,21,0.62,8,3
257,Lucas Wahlin (RW/LW),University of St. Thomas,26,6,15,21,0.81,20,-7
258,Ryan Bottrill (F),Brown University,30,6,15,21,0.70,12,-5
259,Stepan Pokorny (F),Ferris State University,35,6,15,21,0.60,28,-2
260,Clay Cosentino (F),Air Force Academy,36,6,15,21,0.58,10,-19
261,Nate Hanley (C),Union College,35,5,16,21,0.60,2,-5
262,Luke Mittelstadt (D),University of Minnesota,38,5,16,21,0.55,6,22
263,Will Zmolek (D),Bemidji State University,36,4,17,21,0.58,24,2
264,Shai Buium (D),University of Denver,38,4,17,21,0.55,18,8
265,Sean Behrens (D),University of Denver,31,3,18,21,0.68,29,11
266,Ty Gallagher (D),Boston University,40,3,18,21,0.53,24,21
267,Cam Thiesing (C),Ohio State University,40,15,5,20,0.50,58,-1
268,Cy LeClerc (F),University of New Hampshire,35,13,7,20,0.57,6,-13
269,Chase Stevenson (F),University of New Hampshire,35,12,8,20,0.57,28,-3
270,Riley Wallack (F),Long Island University,35,11,9,20,0.57,20,4
271,Nick Bowman (F),Canisius College,35,11,9,20,0.57,27,1
272,Bennett Schimek (F),Providence College,37,11,9,20,0.54,12,7
273,Tyler Mahan (LW),RIT (Rochester Inst. of Tech.),39,11,9,20,0.51,16,14
274,Austin Heidemann (F),RPI (Rensselaer Polytech. Inst.),34,10,10,20,0.59,6,-12
275,Chase Bradley (LW/C),University of Connecticut,35,10,10,20,0.57,61,6
276,Nick Poisson (F),Providence College,37,10,10,20,0.54,17,10
277,Nick DeSantis (F),Cornell University,30,9,11,20,0.67,12,9
278,Nolan Renwick (RW/LW),University of Maine,36,9,11,20,0.56,16,2
279,Luke Tuch (LW),Boston University,40,9,11,20,0.50,21,5
280,Riley Duran (C/RW),Providence College,29,8,12,20,0.69,33,3
281,Ryder Rolston (W/C),University of Notre Dame,27,7,13,20,0.74,4,-4
282,Kyle Jeffers (C/RW),Lindenwood University,28,7,13,20,0.71,26,-8
283,Parker Saretsky (F),Michigan Tech,39,7,13,20,0.51,8,11
284,Christophe Fillion (F),Quinnipiac University,41,7,13,20,0.49,16,21
285,Ben Almquist (F),University of Alaska-Anchorage,28,6,14,20,0.71,8,-10
286,Ryan Finnegan (F),Lindenwood University,29,6,14,20,0.69,6,-8
287,Nick Leivermann (D),University of Notre Dame,29,6,14,20,0.69,18,5
288,Thomas Farrell (D),Army (U.S. Military Academy),37,6,14,20,0.54,18,-18
289,Stan Cooley (C),Colorado College,38,6,14,20,0.53,18,-8
290,John Farinacci (C/RW),Harvard University,19,5,15,20,1.05,2,7
291,Nick Bochen (D),Bentley University,34,5,15,20,0.59,14,-13
292,Braeden Tuck (F),Sacred Heart University,37,5,15,20,0.54,4,-3
293,Will Calverley (C),Merrimack College,38,5,15,20,0.53,27,4
294,Cade Borchardt (F),Minnesota State University (Mankato),39,5,15,20,0.51,12,-3
295,Christian Berger (D),Penn State University,39,5,15,20,0.51,16,8
296,Lucas Vanroboys (C/RW),Bentley University,32,4,16,20,0.63,65,-9
297,Jayden Lee (D),Quinnipiac University,41,4,16,20,0.49,6,29
298,Conner Hutchison (D),Sacred Heart University,34,3,17,20,0.59,6,-18
299,Jon McDonald (D),UMass-Lowell,35,3,17,20,0.57,14,4
300,Ryan O'Neill (F),University of St. Thomas,36,3,17,20,0.56,8,-4
301,Jackson Decker (D),Canisius College,41,3,17,20,0.49,14,-2
302,Zach Vinnell (D/LW),Bowling Green State University,36,1,19,20,0.56,10,-5
303,Anthony Callin (RW/D),Clarkson University,35,11,8,19,0.54,8,-2
304,Ryan Steele (F),Sacred Heart University,26,10,9,19,0.73,10,0
305,Matt Choupani (C),Northeastern University,35,10,9,19,0.54,25,17
306,Judd Caulfield (RW/LW),University of North Dakota,39,10,9,19,0.49,12,8
307,Tyler Watkins (F),Union College,35,9,10,19,0.54,10,-10
308,Donavan Houle (C/RW),University of Maine,36,9,10,19,0.53,16,1
309,Isak Walther (RW),University of Vermont,36,9,10,19,0.53,24,-2
310,Brian Chambers (RW),UMass-Lowell,28,8,11,19,0.68,12,3
311,Brett Rylance (C/W),American International College,33,8,11,19,0.58,8,12
312,Luke Loheit (RW),University of Minnesota-Duluth,35,8,11,19,0.54,53,-5
313,Travis Mitchell (D),Cornell University,34,6,13,19,0.56,20,17
314,Xander Lamppa (F),Penn State University,37,6,13,19,0.51,20,5
315,Drew Bavaro (D),University of Notre Dame,37,6,13,19,0.51,31,-9
316,Jack Perbix (RW/D),Western Michigan University,39,6,13,19,0.49,18,6
317,Brendan Gorman (C),Princeton University,31,5,14,19,0.61,6,-8
318,Caleb Moretz (RW/C),RIT (Rochester Inst. of Tech.),31,5,14,19,0.61,14,4
319,Alex Peterson (F),College of the Holy Cross,38,5,14,19,0.50,37,-1
320,Steven Agriogianis (RW),Mercyhurst University,23,4,15,19,0.83,2,3
321,Nash Nienhuis (D),Michigan State University,32,4,15,19,0.59,31,1
322,Garrett Pyke (D),University of Alaska-Fairbanks,34,4,15,19,0.56,40,14
323,Jimmy Dowd (D),Penn State University,38,4,15,19,0.50,36,10
324,Colton Huard (D),University of New Hampshire,35,3,16,19,0.54,6,-17
325,Lukas Gustafsson (D),Boston College,35,3,16,19,0.54,19,4
326,Ian Moore (D),Harvard University,34,1,18,19,0.56,12,20
327,Jack Cronin (RW),Princeton University,32,12,6,18,0.56,24,-2
328,Glebs Prohorenkovs (F),Niagara University,35,12,6,18,0.51,28,10
329,Mickey Burns (LW),Mercyhurst University,36,11,7,18,0.50,22,0
330,Gavin Hain (C/LW),University of North Dakota,36,11,7,18,0.50,45,-10
331,Jacob Pivonka (C),University of Nebraska-Omaha,37,10,8,18,0.49,16,4
332,Tanner Andrew (C),RIT (Rochester Inst. of Tech.),38,10,8,18,0.47,39,4
333,Cameron Buhl (F),St. Lawrence University,35,9,9,18,0.51,18,-9
334,Nick Capone (RW),University of Connecticut,35,9,9,18,0.51,34,2
335,Mitchell Martan (LW),Bemidji State University,33,8,10,18,0.55,8,2
336,Ryan Taylor (F),Clarkson University,34,8,10,18,0.53,0,-6
337,Tyler Kleven (D),University of North Dakota,35,8,10,18,0.51,84,2
338,Sam Stevens (C/LW),Boston University,40,8,10,18,0.45,26,18
339,Kyle Penney (C),Cornell University,33,7,11,18,0.55,4,9
340,Ethan Frisch (D),University of North Dakota,36,7,11,18,0.50,14,-4
341,Hunter Sansbury (D),Sacred Heart University,37,7,11,18,0.49,23,3
342,Michael Colella (F),Northern Michigan University,37,7,11,18,0.49,25,7
343,Demetrios Koumontzis (LW/D),Arizona State University,37,7,11,18,0.49,29,-8
344,Devin Phillips (F),College of the Holy Cross,38,7,11,18,0.47,22,0
345,Tim Washe (C/LW),Western Michigan University,39,7,11,18,0.46,54,7
346,Elijah Gonsalves (RW/C),RIT (Rochester Inst. of Tech.),39,7,11,18,0.46,55,6
347,Alex Frye (C),Northern Michigan University,38,6,12,18,0.47,16,1
348,Max Kouznetsov (LW/C),Canisius College,42,6,12,18,0.43,25,-11
349,Andrei Buyalsky (C),University of Vermont,34,5,13,18,0.53,6,-2
350,Dylan Peterson (C/RW),Boston University,39,5,13,18,0.46,26,8
351,Jacob Guévin (D),University of Nebraska-Omaha,36,4,14,18,0.50,6,1
352,Tanner Kelly (F),Michigan State University,38,4,14,18,0.47,25,3
353,Ryan Johnson (D),University of Minnesota,40,4,14,18,0.45,8,22
354,Alec Cicero (F),College of the Holy Cross,40,4,14,18,0.45,30,-3
355,Tim Lovell (D),Arizona State University,31,3,15,18,0.58,41,-3
356,Brett Thorne (D),Michigan Tech,34,3,15,18,0.53,34,13
357,Brett Callahan (D),American International College,35,2,16,18,0.51,10,16
358,Josh Zary (F),Long Island University,28,12,5,17,0.61,0,-2
359,Ryan Alexander (C/LW),Arizona State University,35,11,6,17,0.49,20,1
360,Olivier Gauthier (LW),Niagara University,40,11,6,17,0.43,10,1
361,Brendan Nehmer (F),Stonehill College,23,10,7,17,0.74,35,4
362,Tristan Ashbrook (C/RW),Michigan Tech,37,10,7,17,0.46,14,3
363,Ashton Calder (F),Penn State University,38,10,7,17,0.45,27,-1
364,Samu Salminen (C/LW),University of Connecticut,27,9,8,17,0.63,14,4
365,Ian Carpentier (C),Yale University,31,9,8,17,0.55,20,-5
366,Dawson Tritt (F),Lake Superior State University,35,9,8,17,0.49,4,-4
367,Patrick Guzzo (C),Ohio State University,40,9,8,17,0.43,6,3
368,Ryan Kirwan (LW/RW),Penn State University,28,8,9,17,0.61,4,21
369,Nathan Horn (F),Air Force Academy,33,8,9,17,0.52,8,-4
370,Jack Malone (RW/C),Cornell University,34,8,9,17,0.50,6,4
371,Noah Kane (C),Long Island University,34,8,9,17,0.50,14,1
372,Jack Works (F),Michigan Tech,39,8,9,17,0.44,12,5
373,Jason Ahearn (F),Niagara University,17,7,10,17,1.00,16,-1
374,Jordan Tonelli (C/LW),Brown University,23,7,10,17,0.74,26,-3
375,Braiden Dorfman (F),Dartmouth College,30,7,10,17,0.57,25,-15
376,T.J. Walsh (LW),RPI (Rensselaer Polytech. Inst.),35,7,10,17,0.49,4,-8
377,Nick Hale (D),College of the Holy Cross,35,7,10,17,0.49,28,0
378,Bradley Marek (LW),Ferris State University,36,7,10,17,0.47,10,-11
379,Jere Väisänen (F),Bemidji State University,36,7,10,17,0.47,13,5
380,Miroslav Mucha (RW),Michigan State University,38,7,10,17,0.45,6,-3
381,Aaron Huglen (W/C),University of Minnesota,38,7,10,17,0.45,18,7
382,Christian Sarlo (F),Penn State University,38,7,10,17,0.45,29,9
383,Mark Senden (C/LW),University of North Dakota,39,7,10,17,0.44,22,0
384,Jack O'Leary (F),Cornell University,29,6,11,17,0.59,8,19
385,Jake Braccini (RW),University of St. Thomas,32,6,11,17,0.53,9,-15
386,Brandon Puricelli (RW),Lake Superior State University,32,6,11,17,0.53,14,-10
387,Austin Brimmer (RW),Long Island University,32,6,11,17,0.53,27,-3
388,Jordan Di Cicco (D),Long Island University,34,6,11,17,0.50,10,4
389,Jack Williams (RW/LW),Northeastern University,35,6,11,17,0.49,4,5
390,Isaac Howard (LW),University of Minnesota-Duluth,35,6,11,17,0.49,25,-13
391,Owen Gallatin (D),University of Minnesota-Duluth,37,6,11,17,0.46,27,-15
392,Jackson Hallum (F),University of Michigan,39,6,11,17,0.44,45,11
393,Nolan Welsh (F),Long Island University,32,5,12,17,0.53,12,3
394,Anton Rubtsov (F),University of Alaska-Fairbanks,33,5,12,17,0.52,22,5
395,Isac Jonsson (D),UMass-Lowell,34,5,12,17,0.50,6,9
396,Micah Miller (RW/C),St. Cloud State University,41,5,12,17,0.41,18,4
397,Kyle Heath (F),Stonehill College,25,4,13,17,0.68,8,2
398,Noah De la Durantaye (D),Princeton University,31,4,13,17,0.55,22,-8
399,Cole O'Hara (RW),UMass,32,4,13,17,0.53,14,0
400,Oskar Jellvik (LW/C),Boston College,34,4,13,17,0.50,6,-6
401,Ben Meehan (D),UMass-Lowell,34,4,13,17,0.50,43,-1
402,Taige Harding (D),Providence College,37,4,13,17,0.46,19,15
403,Matt Basgall (D),Michigan State University,38,4,13,17,0.45,14,-2
404,Josef Mysak (D),Niagara University,39,3,14,17,0.44,45,-2
405,Matthew Rickard (D),American International College,33,2,15,17,0.52,10,0
406,Ryan Siedem (D),Harvard University,34,1,16,17,0.50,21,12
407,Danny DiGrande (C),Canisius College,27,12,4,16,0.59,27,2
408,Harrison Roy (F),Lake Superior State University,31,12,4,16,0.52,10,-20
409,Luke Haymes (C/LW),Dartmouth College,30,11,5,16,0.53,34,-18
410,Ethan Scardina (C),Bowling Green State University,31,11,5,16,0.52,14,-8
411,Josh Nixon (RW),Union College,34,11,5,16,0.47,45,-7
412,Cole Krygier (D),Michigan State University,38,10,6,16,0.42,60,2
413,Jamie Rome (F),Western Michigan University,30,9,7,16,0.53,8,6
414,Carson Bantle (LW/RW),University of Wisconsin,35,9,7,16,0.46,14,-13
415,Zach Kaiser (C/LW),UMass-Lowell,30,8,8,16,0.53,10,7
416,Ethan Manderville (C),Colgate University,34,8,8,16,0.47,22,-9
417,Michael Sacco (F),Army (U.S. Military Academy),34,8,8,16,0.47,30,-5
418,Dylan James (LW),University of North Dakota,36,8,8,16,0.44,6,4
419,Ryan O'Reilly (W/C),Arizona State University,36,8,8,16,0.44,16,-1
420,Tyler Ghirardosi (F),College of the Holy Cross,37,8,8,16,0.43,31,0
421,Connor Marritt (F),University of Alaska-Anchorage,28,7,9,16,0.57,10,-7
422,Chad Hillebrand (LW/C),Western Michigan University,32,7,9,16,0.50,37,11
423,Alex Gaffney (C),Harvard University,33,7,9,16,0.48,4,4
424,Cole Kodsi (LW),Bentley University,34,7,9,16,0.47,12,2
425,Erik Middendorf (LW),Michigan State University,37,7,9,16,0.43,12,-10
426,Jacques Bouquot (C/LW),University of Vermont,29,6,10,16,0.55,4,-4
427,Jake Gagnon (RW),RPI (Rensselaer Polytech. Inst.),31,6,10,16,0.52,4,-8
428,Damien Carfagna (D),University of New Hampshire,35,6,10,16,0.46,2,-15
429,William Zapernick (C/RW),University of Vermont,36,6,10,16,0.44,31,-18
430,Jakub Sirota (D),University of Maine,36,6,10,16,0.44,39,2
431,Filip Forsmark (LW/RW),Merrimack College,37,6,10,16,0.43,18,4
432,Matt Hubbarde (C),Dartmouth College,30,5,11,16,0.53,12,-13
433,Jack Hughes (C),Northeastern University,32,5,11,16,0.50,16,-14
434,Jack Judson (D),Arizona State University,37,5,11,16,0.43,18,9
435,Jacob Truscott (D),University of Michigan,23,4,12,16,0.70,12,8
436,Zach Bookman (D),Merrimack College,36,4,12,16,0.44,16,1
437,Ty Naaykens (F),St. Lawrence University,31,3,13,16,0.52,6,3
438,T.J. Lloyd (D),University of Alaska-Fairbanks,34,3,13,16,0.47,10,14
439,Mason Waite (D),St. Lawrence University,35,3,13,16,0.46,14,-5
440,Stanislav Demin (D),Merrimack College,37,3,13,16,0.43,18,12
441,Josh Zinger (D),Northern Michigan University,38,3,13,16,0.42,12,1
442,Luke Krys (D),Brown University,30,2,14,16,0.53,49,-8
443,Matt Gosiewski (C),Bentley University,33,2,14,16,0.48,10,-20
444,Derek Daschke (D),University of Minnesota-Duluth,37,2,14,16,0.43,6,-5
445,Jed Pietila (D),Michigan Tech,35,1,15,16,0.46,26,11
446,Davis Pennington (D),University of Nebraska-Omaha,36,1,15,16,0.44,10,5
447,Joe Cassetti (C/LW),Miami University (Ohio),34,10,5,15,0.44,20,-10
448,Anthony Romano (C/RW),Clarkson University,19,9,6,15,0.79,8,6
449,Nick Seitz (F),Princeton University,28,9,6,15,0.54,17,-7
450,Harrison Israels (C),University of Alaska-Fairbanks,34,9,6,15,0.44,12,8
451,Grady Hobbs (RW/LW),RIT (Rochester Inst. of Tech.),34,9,6,15,0.44,30,-4
452,Tyler Schleppe (F),Ferris State University,35,9,6,15,0.43,17,-8
453,Rylee St. Onge (LW),Mercyhurst University,24,8,7,15,0.63,8,1
454,David Chen (F),Yale University,32,8,7,15,0.47,10,-6
455,Harrison Scott (C/LW),Bentley University,32,8,7,15,0.47,30,-10
456,Ondrej Psenicka (RW),Cornell University,34,8,7,15,0.44,10,15
457,Oscar Geschwind (F),American International College,35,8,7,15,0.43,6,-1
458,Chase Yoder (C/W),Providence College,37,8,7,15,0.41,14,3
459,Cade DeStefani (C),Lindenwood University,26,7,8,15,0.58,42,-2
460,Stevie Castagna (F),Bentley University,33,7,8,15,0.45,20,-1
461,Didrik Henbrant (RW/C),University of Maine,34,7,8,15,0.44,24,1
462,Tyler Paquette (RW/C),Penn State University,36,7,8,15,0.42,8,-2
463,Danny Dzhaniyev (F),Penn State University,37,7,8,15,0.41,12,-2
464,Tyler Gratton (RW),Penn State University,38,7,8,15,0.39,18,3
465,Cooper Flinton (LW/RW),Dartmouth College,27,6,9,15,0.56,12,-5
466,Antonio Venuto (RW),Ferris State University,34,6,9,15,0.44,14,-7
467,Erik Urbank (RW),Canisius College,34,6,9,15,0.44,20,8
468,Nolan Sullivan (F),University of Nebraska-Omaha,35,6,9,15,0.43,31,0
469,Parker Brown (F),Air Force Academy,36,6,9,15,0.42,21,-12
470,Jesse Lansdell (LW),University of Notre Dame,36,6,9,15,0.42,64,-6
471,Ondřej Pavel (C/LW),Minnesota State University (Mankato),39,6,9,15,0.38,34,5
472,David Jacobs (RW),Princeton University,32,5,10,15,0.47,22,-11
473,Tyson Jugnauth (D),University of Wisconsin,32,5,10,15,0.47,30,-20
474,P.J. Fletcher (C/RW),Miami University (Ohio),36,5,10,15,0.42,22,-19
475,Hunter Strand (C),University of Notre Dame,37,5,10,15,0.41,21,-11
476,Jan Lasak (RW),St. Lawrence University,34,4,11,15,0.44,2,-1
477,Brenden MacLaren (F),Ferris State University,35,4,11,15,0.43,18,5
478,Lauri Sertti (D),RPI (Rensselaer Polytech. Inst.),35,4,11,15,0.43,31,-6
479,Jake Johnson (D),Quinnipiac University,39,4,11,15,0.38,32,31
480,Simon Labelle (LW),Colgate University,40,4,11,15,0.38,6,1
481,Ben Schoen (C),Penn State University,24,3,12,15,0.63,16,5
482,Robbie Stucker (D),University of Vermont,33,3,12,15,0.45,21,-9
483,Cal Mell (D),Union College,34,3,12,15,0.44,8,-7
484,Case McCarthy (D),Boston University,35,3,12,15,0.43,14,16
485,Michael Gildon (C/LW),Ohio State University,40,3,12,15,0.38,40,0
486,Ben Wozney (D),Bowling Green State University,36,2,13,15,0.42,14,-2
487,Eric Gotz (D),University of Vermont,36,2,13,15,0.42,14,-9
488,Thomas Freel (C),University of Maine,36,2,13,15,0.42,27,0
489,Owen McLaughlin (C),University of North Dakota,37,2,13,15,0.41,10,-9
490,Aidan Fulp (D),Western Michigan University,38,2,13,15,0.39,24,9
491,Evan Stella (D),American International College,39,2,13,15,0.38,35,19
492,Iivari Räsänen (D),Quinnipiac University,41,2,13,15,0.37,12,25
493,Max Dukovac (F),Miami University (Ohio),31,1,14,15,0.48,27,-6
494,Blake Evennou (D),Ferris State University,35,1,14,15,0.43,18,-11
495,Bryan Yoon (D),Colorado College,38,1,14,15,0.39,4,-19
496,John Waldron (F),Miami University (Ohio),29,9,5,14,0.48,16,-17
497,Dylan Pitera (F),Bentley University,33,9,5,14,0.42,16,-9
498,Connor McGrath (C),Ferris State University,33,8,6,14,0.42,14,-7
499,Scout Truman (LW),UMass-Lowell,34,8,6,14,0.41,10,12
500,Matt Allen (F),University of Alaska-Anchorage,27,7,7,14,0.52,22,-5
501,Sean Chisholm (C/LW),Dartmouth College,30,7,7,14,0.47,22,-20
502,Garrett Dahm (F),Mercyhurst University,32,7,7,14,0.44,8,10
503,Red Savage (C),Miami University (Ohio),32,7,7,14,0.44,24,-15
504,Joel Määttä (C),University of Vermont,36,7,7,14,0.39,18,-10
505,Justin Janicke (LW/C),University of Notre Dame,36,7,7,14,0.39,32,3
506,Max Dorrington (RW/LW),St. Lawrence University,36,7,7,14,0.39,36,-1
507,Will Gilson (D),University of Alaska-Anchorage,27,6,8,14,0.52,38,-20
508,McKade Webster (LW),University of Denver,30,6,8,14,0.47,34,6
509,Timo Bakos (F),Lake Superior State University,33,6,8,14,0.42,2,0
510,Owen Cole (C),UMass-Lowell,33,6,8,14,0.42,6,1
511,Jack Quinn (F),Long Island University,36,6,8,14,0.39,6,5
512,Marko Reifenberger (C),Mercyhurst University,36,6,8,14,0.39,23,1
513,Lars Christian Rødne (LW),Niagara University,37,6,8,14,0.38,16,-11
514,Hugh Larkin (RW),Western Michigan University,38,6,8,14,0.37,24,0
515,Lucas Sowder (LW),Minnesota State University (Mankato),25,5,9,14,0.56,8,-1
516,Adam Robbins (F),Princeton University,32,5,9,14,0.44,38,-9
517,Kaden Pickering (RW),Bemidji State University,36,5,9,14,0.39,10,-6
518,Marshall Warren (D),Boston College,36,5,9,14,0.39,12,0
519,Ryan Richardson (LW),Clarkson University,37,5,9,14,0.38,10,-5
520,Nic Belpedio (D),Colgate University,40,5,9,14,0.35,14,-6
521,Briggs Gammill (F),Yale University,32,4,10,14,0.44,12,-8
522,Simon Kjellberg (D),Northern Michigan University,32,4,10,14,0.44,24,4
523,Ryan Lautenbach (RW/LW),UMass,33,4,10,14,0.42,20,0
524,Chaz Smedsrud (LW),Union College,34,4,10,14,0.41,8,-8
525,Jake Crespi (D),Michigan Tech,34,4,10,14,0.41,30,10
526,Jake Flynn (D),University of Connecticut,35,4,10,14,0.40,12,18
527,Blake Humphrey (C),Sacred Heart University,37,4,10,14,0.38,10,1
528,Ethan Edwards (D),University of Michigan,37,4,10,14,0.38,69,3
529,Matthew Cassidy (RW),Ohio State University,33,3,11,14,0.42,10,-1
530,Max Smolinski (D),RPI (Rensselaer Polytech. Inst.),35,3,11,14,0.40,16,-12
531,Lucas Mercuri (C/RW),UMass,35,3,11,14,0.40,33,0
532,Cade Townend (D),Mercyhurst University,36,3,11,14,0.39,12,-8
533,Hampus Rydqvist (D),Miami University (Ohio),36,3,11,14,0.39,50,-18
534,Louis Jamernik (RW),University of North Dakota,39,3,11,14,0.36,22,-1
535,Scooter Brickey (D),Ohio State University,40,3,11,14,0.35,30,10
536,Nicklas Andrews (D),Colorado College,37,2,12,14,0.38,14,-16
537,Nick Nardella (RW),Michigan Tech,32,1,13,14,0.44,12,-1
538,Philippe Chapleau (D),St. Lawrence University,35,1,13,14,0.40,11,-11
539,Hunter McDonald (D),Northeastern University,35,1,13,14,0.40,56,21
540,Reid Irwin (D/C),Colgate University,39,1,13,14,0.36,45,1
541,Mathew Shatsky (D),College of the Holy Cross,41,1,13,14,0.34,29,-7
542,Liam Robertson (C),Union College,35,9,4,13,0.37,52,-6
543,Kyler Head (F),Mercyhurst University,28,8,5,13,0.46,18,-8
544,Luke Manning (C/W),University of St. Thomas,35,8,5,13,0.37,10,-10
545,Daniel Ebrahim (LW),Sacred Heart University,27,7,6,13,0.48,10,-4
546,Jack Adams (RW/C),University of Notre Dame,32,7,6,13,0.41,10,0
547,Jaroslav Chmelar (RW/LW),Providence College,33,7,6,13,0.39,26,-2
548,Caden Villegas (F),Union College,34,7,6,13,0.38,4,3
549,Mitchel Deelstra (LW/C),Ferris State University,34,7,6,13,0.38,47,-7
550,Jordan Seyfert (C),Merrimack College,35,7,6,13,0.37,10,11
551,Landon Slaggert (LW/C),University of Notre Dame,35,7,6,13,0.37,14,-5
552,Joey Cipollone (C),Quinnipiac University,41,7,6,13,0.32,8,14
553,Cole Donhauser (C/W),Yale University,27,6,7,13,0.48,32,1
554,Brett Bliss (D),Brown University,30,6,7,13,0.43,39,-7
555,Jared Westcott (C/LW),Lake Superior State University,32,6,7,13,0.41,32,-10
556,Marek Hejduk (F),Harvard University,34,6,7,13,0.38,14,-5
557,Justin Lee (D),University of Denver,40,6,7,13,0.33,59,30
558,Jamie Armstrong (LW/RW),Boston University,29,5,8,13,0.45,6,13
559,Carson Brière (C/RW),Mercyhurst University,30,5,8,13,0.43,14,-7
560,Simon Gravel (C/RW),Canisius College,31,5,8,13,0.42,9,1
561,Kyle Gaffney (F),University of Alaska-Fairbanks,33,5,8,13,0.39,13,9
562,Andrew DeCarlo (F),Air Force Academy,33,5,8,13,0.39,34,-6
563,Ryan Black (RW),University of New Hampshire,34,5,8,13,0.38,0,-10
564,Eric Martin (F),Bemidji State University,24,4,9,13,0.54,6,-8
565,Jonathan Bendorf (LW),Mercyhurst University,34,4,9,13,0.38,2,-13
566,Baker Shore (RW),Harvard University,34,4,9,13,0.38,14,3
567,Jake Stella (LW),UMass-Lowell,36,4,9,13,0.36,4,-1
568,Carter Loney (C),University of Minnesota-Duluth,37,4,9,13,0.35,27,-6
569,Carter Jones (F),Bemidji State University,23,3,10,13,0.57,4,-1
570,Cam Collins (F),Stonehill College,23,3,10,13,0.57,8,5
571,Cooper Moore (D),University of North Dakota,31,3,10,13,0.42,34,-12
572,Dustin Geregach (D),Mercyhurst University,32,3,10,13,0.41,10,-4
573,Christopher Theodore (LW),Union College,34,3,10,13,0.38,10,-11
574,John Jaworski (F),Sacred Heart University,36,3,10,13,0.36,22,4
575,Tyler Cristall (F),St. Lawrence University,32,2,11,13,0.41,8,2
576,Kyle Hallbauer (D),RPI (Rensselaer Polytech. Inst.),35,2,11,13,0.37,14,-9
577,Jordan Power (D),Clarkson University,37,2,11,13,0.35,18,7
578,Ryan Beck (C),Colorado College,38,2,11,13,0.34,14,-11
579,Kyle Mayhew (D),University of Denver,40,2,11,13,0.33,18,20
580,Spencer Cox (D/C),Long Island University,34,1,12,13,0.38,10,0
581,David Breazeale (D),University of Maine,36,1,12,13,0.36,14,1
582,Taylor Makar (LW/C),UMass,32,10,2,12,0.38,54,0
583,James Crossman (D),Brown University,29,9,3,12,0.41,33,1
584,Michael Cameron (C),UMass,31,9,3,12,0.39,0,-4
585,Jared Wright (RW),University of Denver,34,8,4,12,0.35,2,13
586,Nicholas Zabaneh (C/LW),Boston University,35,8,4,12,0.34,14,6
587,Jakov Novak (LW/C),Northeastern University,35,8,4,12,0.34,26,4
588,Max Pineo (RW),Stonehill College,25,7,5,12,0.48,14,0
589,Reilly Connors (C/RW),Yale University,31,7,5,12,0.39,26,-1
590,Mac Welsher (C),Merrimack College,32,7,5,12,0.38,12,5
591,Timofei Khokhlachev (LW),American International College,35,7,5,12,0.34,22,9
592,Matt Kopperud (C),Arizona State University,21,6,6,12,0.57,30,-6
593,Adam Conquest (RW),Lindenwood University,22,6,6,12,0.55,6,-3
594,Nolan Fitzpatrick (F),Stonehill College,24,6,6,12,0.50,6,5
595,Filip Fornåå Svensson (C/RW),UMass-Lowell,28,6,6,12,0.43,12,5
596,Aleksi Peltonen (F),St. Lawrence University,29,6,6,12,0.41,2,2
597,Gregory Lapointe (F),St. Lawrence University,30,6,6,12,0.40,13,-3
598,Jake Percival (F),University of Connecticut,34,6,6,12,0.35,9,3
599,Simon Isabelle (RW),RIT (Rochester Inst. of Tech.),34,6,6,12,0.35,28,1
600,Gueorgui Feduolov (F),Mercyhurst University,35,6,6,12,0.34,20,-15
601,Tiernan Shoudy (F),Michigan State University,38,6,6,12,0.32,20,1
602,Grayson Constable (F),College of the Holy Cross,40,6,6,12,0.30,12,-10
603,Liam Walsh (LW),Northeastern University,23,5,7,12,0.52,10,9
604,Arlo Merritt (C),Bentley University,28,5,7,12,0.43,12,-5
605,Cole Quisenberry (F),Brown University,29,5,7,12,0.41,8,-4
606,Jack Gorniak (LW/C),University of Wisconsin,31,5,7,12,0.39,30,-5
607,Logan Will (F),Colorado College,33,5,7,12,0.36,12,-4
608,Owen Fowler (LW),UMass-Lowell,33,5,7,12,0.36,18,4
609,Charlie Stramel (C/RW),University of Wisconsin,33,5,7,12,0.36,59,-10
610,Austin Schwartz (F),Air Force Academy,34,5,7,12,0.35,2,2
611,Jake Schmaltz (LW/C),University of North Dakota,34,5,7,12,0.35,2,-8
612,Matt Koethe (F),University of Alaska-Fairbanks,34,5,7,12,0.35,33,0
613,Ryan Leibold (F),Merrimack College,38,5,7,12,0.32,27,-2
614,Mark Estapa (F),University of Michigan,40,5,7,12,0.30,89,6
615,Bradley Cocca (C),Brown University,29,4,8,12,0.41,14,-3
616,Jake Willets (D),Lake Superior State University,33,4,8,12,0.36,8,-9
617,Jackson Jutting (F),Bemidji State University,33,4,8,12,0.36,12,-10
618,Aidan Spellacy (F),St. Cloud State University,35,4,8,12,0.34,11,9
619,Simon Mack (D),Penn State University,36,4,8,12,0.33,2,14
620,Tyler Duke (D),Ohio State University,40,4,8,12,0.30,45,9
621,Tomas Mazura (C),St. Lawrence University,28,3,9,12,0.43,8,2
622,Joey Musa (F),Dartmouth College,30,3,9,12,0.40,31,-14
623,Grant Loven (C),Canisius College,32,3,9,12,0.38,18,6
624,Felikss Gavars (F),St. Lawrence University,36,3,9,12,0.33,8,-2
625,Luke Antonacci (D),University of Maine,36,3,9,12,0.33,10,2
626,Noah Wilson (D),Army (U.S. Military Academy),37,3,9,12,0.32,39,0
627,Aiden Yakimchuk (D),Lindenwood University,30,2,10,12,0.40,8,-8
628,Joaquim Lemay (D),University of Nebraska-Omaha,32,2,10,12,0.38,23,0
629,Jack Agnew (D),RPI (Rensselaer Polytech. Inst.),32,2,10,12,0.38,24,-12
630,John Driscoll (D),Army (U.S. Military Academy),33,2,10,12,0.36,16,-9
631,John Spetz (D),University of Connecticut,35,2,10,12,0.34,12,-7
632,Cameron Recchi (C/LW),University of St. Thomas,35,2,10,12,0.34,25,-16
633,Logan Britt (D),Sacred Heart University,37,2,10,12,0.32,24,1
634,Mack Oliphant (D),College of the Holy Cross,41,2,10,12,0.29,10,-4
635,Jayden Struble (D),Northeastern University,31,1,11,12,0.39,56,8
636,Noah Carlin (D),Niagara University,33,1,11,12,0.36,27,-1
637,Simon Falk (RW),University of Alaska-Fairbanks,33,9,2,11,0.33,8,11
638,Tyler Coffey (F),Colorado College,37,8,3,11,0.30,8,-8
639,Alton McDermott (RW),Canisius College,27,7,4,11,0.41,10,-2
640,Eric Ciccolini (RW),University of Michigan,31,7,4,11,0.35,14,3
641,Owen Farris (C),Union College,33,7,4,11,0.33,35,-6
642,Connor Kurth (F),University of Minnesota,38,7,4,11,0.29,35,8
643,Caige Sterzer (F),Lindenwood University,26,6,5,11,0.42,48,-1
644,Ty Amonte (RW),University of Connecticut,30,6,5,11,0.37,10,-2
645,Zach Urdahl (LW/RW),University of Wisconsin,34,6,5,11,0.32,14,-3
646,Zach Tupker (C),Cornell University,34,6,5,11,0.32,20,5
647,Caleb Hite (F),University of Alaska-Anchorage,27,5,6,11,0.41,23,-14
648,Josh Groll (C/LW),Minnesota State University (Mankato),30,5,6,11,0.37,8,7
649,Daniel Panetta (C),Colgate University,34,5,6,11,0.32,4,1
650,Lucas Thorne (C),College of the Holy Cross,36,5,6,11,0.31,12,-10
651,Chris Grando (LW),Arizona State University,37,5,6,11,0.30,8,-5
652,Kash Rasmussen (F),Michigan Tech,37,5,6,11,0.30,17,-5
653,Brandon Holt (D),University of Maine,24,4,7,11,0.46,2,3
654,Ethan Phillips (C/RW),Boston University,29,4,7,11,0.38,14,0
655,Travis Shoudy (D),Ferris State University,32,4,7,11,0.34,16,6
656,J.D. Pogue (LW),Canisius College,32,4,7,11,0.34,64,-5
657,Markus Boguslavsky (RW),Canisius College,37,4,7,11,0.30,41,4
658,C.J. McGee (D),Quinnipiac University,41,4,7,11,0.27,18,9
659,John Fusco (D),Dartmouth College,22,3,8,11,0.50,23,-8
660,Nicholas Cafarelli (F),University of New Hampshire,23,3,8,11,0.48,29,-1
661,Liam Valente (LW/C),Providence College,30,3,8,11,0.37,10,2
662,Mark Hillier (F),Merrimack College,31,3,8,11,0.35,4,-3
663,Axel Kumlin (D),Miami University (Ohio),32,3,8,11,0.34,19,-24
664,Sam Stange (RW),University of Wisconsin,34,3,8,11,0.32,2,-8
665,Markuss Komuls (D),University of Alaska-Fairbanks,34,3,8,11,0.32,16,8
666,Max Coyle (D),Bowling Green State University,34,3,8,11,0.32,34,-1
667,Arvils Bergmanis (D),University of Alaska-Fairbanks,34,3,8,11,0.32,79,10
668,Chris Hedden (D),Air Force Academy,35,3,8,11,0.31,12,-6
669,Brendan Bushy (D),St. Cloud State University,41,3,8,11,0.27,33,16
670,Samuel Brennan (D),Air Force Academy,22,2,9,11,0.50,45,0
671,Joe Prouty (D),Lindenwood University,30,2,9,11,0.37,36,-6
672,Dylan Gratton (D),Penn State University,33,2,9,11,0.33,2,15
673,Chase Blackmun (D),University of Notre Dame,34,2,9,11,0.32,10,3
674,Grayson Arnott (D),University of Maine,34,2,9,11,0.32,25,-1
675,Dalton Norris (D),Bowling Green State University,36,2,9,11,0.31,8,-1
676,Tristan Crozier (F),Merrimack College,38,2,9,11,0.29,14,-3
677,Michael Mancinelli (C),University of Maine,30,1,10,11,0.37,6,3
678,Nick Carabin (D),Princeton University,32,1,10,11,0.34,28,7
679,Jarrett Lee (F),University of St. Thomas,34,1,10,11,0.32,18,-12
680,Ty Farmer (D),University of North Dakota,37,1,10,11,0.30,27,-7
681,Ethan Szmagaj (D),Arizona State University,39,1,10,11,0.28,40,-7
682,Ben Dexheimer (D),University of Wisconsin,35,0,11,11,0.31,12,-11
683,Ondrej Trejbal (D),St. Cloud State University,38,0,11,11,0.29,12,3
684,Jacob Nordqvist (D),Quinnipiac University,38,0,11,11,0.29,20,15
685,Keaton Pehrson (D),University of Michigan,39,0,11,11,0.28,0,12
686,Isaiah Fox (F),Long Island University,24,9,1,10,0.42,26,-2
687,Alexander Lundman (RW/LW),Bemidji State University,35,9,1,10,0.29,10,7
688,Patrick Moynihan (RW),Providence College,34,7,3,10,0.29,41,-2
689,Sullivan Mack (C/LW),Cornell University,25,6,4,10,0.40,8,6
690,Carter Korpi (F),Union College,31,6,4,10,0.32,14,-4
691,Jesse Tucker (C),Michigan State University,31,6,4,10,0.32,24,-2
692,Cole Hanson (F),University of Maine,36,6,4,10,0.28,22,-5
693,Mike Posma (C/LW),Boston College,36,6,4,10,0.28,23,2
694,Ryan Savage (RW),Miami University (Ohio),36,6,4,10,0.28,28,-6
695,Jamie Engelbert (C),Providence College,37,5,5,10,0.27,14,12
696,Ben Raymond (C/LW),Colgate University,39,5,5,10,0.26,14,-6
697,Brett Bamber (D),University of Alaska-Anchorage,27,4,6,10,0.37,19,-3
698,Dimitri Mikrogiannakis (D),RIT (Rochester Inst. of Tech.),28,4,6,10,0.36,30,10
699,Spencer Kersten (RW/LW),Princeton University,31,4,6,10,0.32,20,-3
700,Nik Allain (F),Yale University,32,4,6,10,0.31,31,-1
701,Adam Eisele (F),Minnesota State University (Mankato),33,4,6,10,0.30,6,8
702,Matt Slick (D),Ferris State University,33,4,6,10,0.30,17,-6
703,Zach Krajnik (C),Minnesota State University (Mankato),34,4,6,10,0.29,14,4
704,Matt DeMelis (F),Northeastern University,35,4,6,10,0.29,6,5
705,Connor Eddy (C),Northern Michigan University,35,4,6,10,0.29,14,5
706,Matthew Gleason (C),Colorado College,35,4,6,10,0.29,40,-19
707,Jordan Steinmetz (F),St. Lawrence University,35,4,6,10,0.29,70,-10
708,Connor Joyce (C),Boston College,36,4,6,10,0.28,4,-2
709,Nick Granowicz (C/RW),University of Michigan,36,4,6,10,0.28,16,5
710,David Gucciardi (D),Michigan State University,36,4,6,10,0.28,43,0
711,Ryan McGuire (C/RW),Colgate University,40,4,6,10,0.25,37,-6
712,Sean Donaldson (LW),Cornell University,22,3,7,10,0.45,0,4
713,Matt Sutton (F),Brown University,26,3,7,10,0.38,6,-3
714,Caleb Price (D),Lindenwood University,30,3,7,10,0.33,12,-12
715,Mitchell Allard (LW),Lindenwood University,30,3,7,10,0.33,48,-7
716,Nick Nardecchia (RW),Ferris State University,35,3,7,10,0.29,27,1
717,Paul DeNaples (D),Penn State University,39,3,7,10,0.26,8,8
718,Cédric Fiedler (D),Western Michigan University,39,3,7,10,0.26,17,24
719,Chris Lipe (D),Michigan Tech,30,2,8,10,0.33,22,-1
720,Jack Anderson (D),Lindenwood University,30,2,8,10,0.33,23,-3
721,Matt Crasa (C/RW),UMass-Lowell,31,2,8,10,0.32,16,-6
722,Josh Luedtke (D),St. Cloud State University,32,2,8,10,0.31,48,19
723,Jarod Crespo (D),Penn State University,33,2,8,10,0.30,15,-1
724,Cam Burke (C),Boston College,36,2,8,10,0.28,6,-9
725,Ryan Chesley (D),University of Minnesota,36,2,8,10,0.28,13,15
726,Ethan Straky (D),Colorado College,38,2,8,10,0.26,8,-9
727,Ryan Brushett (C),UMass-Lowell,24,1,9,10,0.42,12,0
728,Brenden Datema (D),Canisius College,30,1,9,10,0.33,35,4
729,Jérémie Bucheler (D),Northeastern University,32,1,9,10,0.31,14,7
730,Valtteri Piironen (D),Long Island University,32,1,9,10,0.31,14,3
731,Vincent Borgesi (D),Northeastern University,32,1,9,10,0.31,24,7
732,Nikolai Jenson (D),University of New Hampshire,33,1,9,10,0.30,33,6
733,Tommy Bergsland (D),Colgate University,40,1,9,10,0.25,25,-10
734,Derek Hamelin (D),University of Alaska-Anchorage,26,0,10,10,0.38,12,1
735,Jake Cady (C),Stonehill College,25,7,2,9,0.36,30,-3
736,Vincent De Mey (F),Northern Michigan University,34,7,2,9,0.26,22,-2
737,Joshua Barnes (C),American International College,21,5,4,9,0.43,6,-3
738,Tyson Dyck (C),UMass,28,5,4,9,0.32,8,-4
739,Jacob Slipec (F),University of Nebraska-Omaha,28,5,4,9,0.32,8,9
740,Gavin Puskar (F),Brown University,30,5,4,9,0.30,14,-9
741,Keanan Stewart (F),Mercyhurst University,34,5,4,9,0.26,12,-6
742,Matt Koopman (C/LW),UMass,35,5,4,9,0.26,0,-2
743,Mick Messner (LW),Merrimack College,35,5,4,9,0.26,24,6
744,Craig Needham (C),Providence College,37,5,4,9,0.24,16,-10
745,Holt Oliphant (F),Air Force Academy,27,4,5,9,0.33,6,5
746,David Jankowski (C/RW),Michigan Tech,28,4,5,9,0.32,2,-1
747,Tyler Campbell (C),Dartmouth College,28,4,5,9,0.32,4,2
748,Jimmy Glynn (F),University of Nebraska-Omaha,30,4,5,9,0.30,18,-5
749,Aaron Grounds (F),American International College,31,4,5,9,0.29,19,3
750,Connor Sullivan (D),Yale University,31,4,5,9,0.29,26,-3
751,Mike Brown (D),Merrimack College,33,4,5,9,0.27,27,6
752,Tristan Fraser (F),University of Connecticut,34,4,5,9,0.26,16,7
753,Owen Lindmark (C/RW),University of Wisconsin,36,4,5,9,0.25,10,-6
754,Jesse Jacques (F),University of Minnesota-Duluth,37,4,5,9,0.24,16,-4
755,Brayden Nicholetts (F),University of Alaska-Fairbanks,19,3,6,9,0.47,24,6
756,Ben Strinden (C),University of North Dakota,22,3,6,9,0.41,14,6
757,Ray Fust (LW/RW),University of Nebraska-Omaha,24,3,6,9,0.38,4,0
758,Colin Doyle (C),University of Alaska-Fairbanks,27,3,6,9,0.33,6,14
759,Josh Latta (F),Bentley University,27,3,6,9,0.33,16,-6
760,Nathan Plessis (F),Brown University,30,3,6,9,0.30,56,-4
761,Mason Snell (D),Union College,31,3,6,9,0.29,16,-5
762,Spencer Meier (D),St. Cloud State University,32,3,6,9,0.28,2,7
763,Grant Silianoff (RW),University of Notre Dame,33,3,6,9,0.27,6,-5
764,Matthew Kellenberger (D),RIT (Rochester Inst. of Tech.),37,3,6,9,0.24,33,-2
765,Levi Glasman (LW),Colgate University,38,3,6,9,0.24,6,-4
766,Aaron Bohlinger (D),UMass,25,2,7,9,0.36,8,-2
767,Nick Portz (F),University of North Dakota,27,2,7,9,0.33,4,1
768,Tim Makowski (D),St. Lawrence University,32,2,7,9,0.28,60,2
769,A.J. Macaulay (D),University of Alaska-Fairbanks,33,2,7,9,0.27,12,13
770,Tim Rego (D),Cornell University,33,2,7,9,0.27,16,18
771,Jack Jeffers (F),Lake Superior State University,33,2,7,9,0.27,25,-11
772,Nick Young (D),Union College,34,2,7,9,0.26,43,3
773,Harrison Rees (D),University of Connecticut,35,2,7,9,0.26,14,6
774,Rieger Lorenz (LW/C),University of Denver,37,2,7,9,0.24,20,0
775,Ryan Nicholson (D),RIT (Rochester Inst. of Tech.),37,2,7,9,0.24,32,1
776,Arvid Caderoth (C/RW),Michigan Tech,38,2,7,9,0.24,31,-4
777,Charles-Alexis Legault (D),Quinnipiac University,40,2,7,9,0.23,22,9
778,Jackson Munro (D),Brown University,20,1,8,9,0.45,8,-5
779,Will Dineen (LW/RW),Yale University,27,1,8,9,0.33,33,-4
780,Preston Brodziak (F),Long Island University,28,1,8,9,0.32,12,-2
781,Jackson Pierson (C),University of Notre Dame,31,1,8,9,0.29,10,-5
782,Nolan Krenzen (D),University of Nebraska-Omaha,34,1,8,9,0.26,4,3
783,Alex Gagne (D),University of New Hampshire,35,1,8,9,0.26,14,-6
784,Steven Bellini (D),Minnesota State University (Mankato),39,1,8,9,0.23,8,10
785,Dustyn McFaul (D),Clarkson University,30,0,9,9,0.30,33,12
786,Ryan Sidorski (D),University of North Dakota,36,0,9,9,0.25,16,4
787,Carter Schade (D),Penn State University,36,0,9,9,0.25,18,-3
788,Bobby Young (C),College of the Holy Cross,36,0,9,9,0.25,32,2
789,Jacob Semik (D),Arizona State University,39,0,9,9,0.23,6,6
790,Sam Morton (C/LW),Minnesota State University (Mankato),10,6,2,8,0.80,2,1
791,Mason McCormick (LW),Air Force Academy,34,6,2,8,0.24,49,3
792,Casey McDonald (F),American International College,18,5,3,8,0.44,10,1
793,Zakary Karpa (C/LW),Harvard University,22,5,3,8,0.36,6,2
794,Kamil Sadlocha (C),Ohio State University,26,5,3,8,0.31,16,-1
795,John Evans (F),RPI (Rensselaer Polytech. Inst.),29,5,3,8,0.28,6,-6
796,Kyle Bettens (RW/C),University of Minnesota-Duluth,33,5,3,8,0.24,12,1
797,Lucas Kanta (LW),Army (U.S. Military Academy),33,5,3,8,0.24,16,-8
798,Kyle Looft (D),Bemidji State University,36,5,3,8,0.22,19,-6
799,Darian Gotz (D),University of Minnesota-Duluth,37,5,3,8,0.22,16,5
800,Drake Burgin (D),St. Lawrence University,32,4,4,8,0.25,16,-1
801,Jack Horbach (RW/C),University of Wisconsin,32,4,4,8,0.25,40,-12
802,Stefano Bottini (LW/RW),Canisius College,32,4,4,8,0.25,55,2
803,Philip Tresca (C),Harvard University,34,4,4,8,0.24,20,-7
804,Will Hillman (F),Minnesota State University (Mankato),35,4,4,8,0.23,4,8
805,Brody Lamb (RW),University of Minnesota,39,4,4,8,0.21,4,3
806,Winter Wallace (RW),Cornell University,23,3,5,8,0.35,18,7
807,Félix Trudeau (LW),University of Maine,28,3,5,8,0.29,14,2
808,Luke Mylymok (W/C),University of Minnesota-Duluth,31,3,5,8,0.26,17,-7
809,Jack Rogers (F),St. Cloud State University,34,3,5,8,0.24,14,-2
810,Solag Bakich (F),University of Notre Dame,35,3,5,8,0.23,20,-2
811,Austen Long (RW/C),American International College,35,3,5,8,0.23,43,8
812,Bennett Norlin (F),Air Force Academy,36,3,5,8,0.22,4,-14
813,Jaden Grant (F),Bowling Green State University,36,3,5,8,0.22,12,-15
814,Trey Taylor (D),Clarkson University,36,3,5,8,0.22,18,-5
815,Marek Korencik (D),UMass-Lowell,36,3,5,8,0.22,32,1
816,Mike Van Unen (D),Northern Michigan University,36,3,5,8,0.22,36,-2
817,Matt DeBoer (W),College of the Holy Cross,39,3,5,8,0.21,18,-8
818,Andrew Petrucci (C),RIT (Rochester Inst. of Tech.),39,3,5,8,0.21,33,2
819,Victor Czerneckianair (C),Quinnipiac University,40,3,5,8,0.20,13,5
820,Kabore Dunn (D),Lindenwood University,23,2,6,8,0.35,14,-6
821,Jarred White (C),University of Alaska-Anchorage,24,2,6,8,0.33,26,-9
822,Casey Severo (C),Harvard University,27,2,6,8,0.30,2,8
823,Jayden Sison (RW),Princeton University,30,2,6,8,0.27,10,-2
824,John Beaton (C),RPI (Rensselaer Polytech. Inst.),31,2,6,8,0.26,4,-8
825,Ryan Healey (D),Harvard University,34,2,6,8,0.24,23,-1
826,Hudson Lambert (D),Canisius College,35,2,6,8,0.23,13,-3
827,Braden Doyle (D),Northeastern University,23,1,7,8,0.35,6,8
828,Teddy McElaney (D),Stonehill College,23,1,7,8,0.35,18,7
829,Connor Mylymok (RW/LW),University of Alaska-Fairbanks,29,1,7,8,0.28,83,5
830,Cameron MacDonald (F),Dartmouth College,30,1,7,8,0.27,17,-22
831,Guillaume Richard (D),Providence College,31,1,7,8,0.26,6,-6
832,Trevor Zins (D),University of St. Thomas,34,1,7,8,0.24,10,-11
833,Kirby Proctor (D),University of Nebraska-Omaha,37,1,7,8,0.22,30,-4
834,Samuli Niinisaari (D),Brown University,30,0,8,8,0.27,8,-6
835,Victor Mancini (D),University of Nebraska-Omaha,32,0,8,8,0.25,10,2
836,Drew Cooper (D),Ferris State University,32,0,8,8,0.25,16,-12
837,Benjamin Tupker (LW),Union College,35,6,1,7,0.20,20,-6
838,Danny Pearson (F),Bentley University,22,5,2,7,0.32,4,-3
839,Ryan Shostak (F),Brown University,29,5,2,7,0.24,4,-4
840,Teddy Lagerback (LW),Arizona State University,30,5,2,7,0.23,27,1
841,Josh Boyer (C),St. Lawrence University,36,5,2,7,0.19,24,-2
842,John Peloso (F),Stonehill College,14,4,3,7,0.50,5,1
843,Tristan Lemyre (C),University of Denver,17,4,3,7,0.41,2,7
844,Reilly Moran (F),St. Lawrence University,27,4,3,7,0.26,8,2
845,Cooper Gay (LW/RW),University of St. Thomas,30,4,3,7,0.23,13,0
846,Liam Malmquist (F),University of Wisconsin,33,4,3,7,0.21,12,-6
847,Jakub Lewandowski (F),Bemidji State University,34,4,3,7,0.21,24,-2
848,Caiden Gault (F),Ferris State University,21,3,4,7,0.33,12,2
849,Logan Ganie (LW),Michigan Tech,24,3,4,7,0.29,8,1
850,Chase Brand (C),St. Cloud State University,24,3,4,7,0.29,11,4
851,Noah Serdachny (F),Colorado College,27,3,4,7,0.26,2,-3
852,Jamie Collins (F),University of Alaska-Anchorage,27,3,4,7,0.26,8,-8
853,Jake Dunlap (F),University of New Hampshire,28,3,4,7,0.25,10,-6
854,Jack Jensen (LW),Arizona State University,28,3,4,7,0.25,24,1
855,Quinn Emerson (RW/C),Bowling Green State University,29,3,4,7,0.24,14,-3
856,William Lemay (C/LW),University of Vermont,30,3,4,7,0.23,8,-10
857,Tyler Carpenter (F),University of Notre Dame,30,3,4,7,0.23,8,2
858,Mason Salquist (F),St. Cloud State University,40,3,4,7,0.18,10,3
859,Nolan Moyle (C/RW),University of Michigan,40,3,4,7,0.18,36,4
860,Frank Nazar (C/RW),University of Michigan,13,2,5,7,0.54,0,6
861,Gleb Veremyev (C/LW),Colorado College,14,2,5,7,0.50,18,-9
862,Matt Stienburg (C),Cornell University,18,2,5,7,0.39,18,-2
863,Will Cohen (D),Stonehill College,19,2,5,7,0.37,4,2
864,Brock Bremer (LW),University of Nebraska-Omaha,22,2,5,7,0.32,30,0
865,Jacob Dirks (F),Ferris State University,23,2,5,7,0.30,10,-3
866,Ryan Nause (D),Bentley University,24,2,5,7,0.29,20,-8
867,Cody Monds (RW/C),Providence College,25,2,5,7,0.28,4,-4
868,Adam Pitters (F),Bowling Green State University,27,2,5,7,0.26,32,-1
869,Stiven Sardaryan (RW/C),University of New Hampshire,29,2,5,7,0.24,8,-1
870,Joe Winkelmann (C),Bentley University,30,2,5,7,0.23,4,-2
871,Joey Molenaar (F),St. Cloud State University,30,2,5,7,0.23,4,5
872,Cooper Wylie (D),St. Cloud State University,30,2,5,7,0.23,10,1
873,Julian Kislin (D),Sacred Heart University,30,2,5,7,0.23,10,3
874,Drew Kuzma (F),Lindenwood University,30,2,5,7,0.23,28,-10
875,Reid Pabich (C),University of Maine,31,2,5,7,0.23,4,-2
876,Cullen Ferguson (D),Union College,34,2,5,7,0.21,34,-10
877,Dominick Mersch (C),University of Wisconsin,35,2,5,7,0.20,15,-1
878,Luca Fantilli (D),University of Michigan,35,2,5,7,0.20,18,4
879,Jared Kucharek (D),Lake Superior State University,35,2,5,7,0.20,19,-7
880,Mitchell Digby (D),Air Force Academy,35,2,5,7,0.20,28,-10
881,Roman Kinal (D),University of Connecticut,35,2,5,7,0.20,42,-7
882,Charlie Leddy (D),Boston College,35,2,5,7,0.20,47,0
883,Tanner Laderoute (RW/C),University of Minnesota-Duluth,37,2,5,7,0.19,6,-8
884,Jacob Bauer (D),Western Michigan University,38,2,5,7,0.18,10,7
885,Aiden Gallacher (D),Northern Michigan University,38,2,5,7,0.18,39,6
886,Daniel Hilsendager (D),Western Michigan University,39,2,5,7,0.18,12,7
887,Seth Bernard-Docker (D),Bentley University,20,1,6,7,0.35,22,-2
888,Luc Wilson (F),Minnesota State University (Mankato),21,1,6,7,0.33,8,4
889,Reilly Funk (C),Northern Michigan University,23,1,6,7,0.30,21,0
890,Ryan Davies (D),Stonehill College,24,1,6,7,0.29,14,-3
891,Steve Holtz (D),University of Michigan,25,1,6,7,0.28,38,11
892,Christian Gorscak (F),Niagara University,26,1,6,7,0.27,4,-6
893,Coltan Wilkie (F),Lindenwood University,26,1,6,7,0.27,12,-7
894,Cody Schiavon (D),Canisius College,26,1,6,7,0.27,14,5
895,Carson Kosobud (D),University of Alaska-Anchorage,27,1,6,7,0.26,44,-11
896,Mason Klee (D),RPI (Rensselaer Polytech. Inst.),31,1,6,7,0.23,39,-5
897,Michael Suda (D),Cornell University,33,1,6,7,0.21,8,8
898,Eric Faith (LW),UMass,33,1,6,7,0.21,16,-4
899,Ben Schultheis (D),Ferris State University,33,1,6,7,0.21,16,-8
900,Patrick Smyth (F),Army (U.S. Military Academy),33,1,6,7,0.21,18,-10
901,Connor Mayer (D),Colorado College,34,1,6,7,0.21,22,6
902,Daniel Laatsch (D),University of Wisconsin,36,1,6,7,0.19,6,-5
903,Spencer Berry (D),RIT (Rochester Inst. of Tech.),37,1,6,7,0.19,25,4
904,Jack Millar (D),Colorado College,38,1,6,7,0.18,25,1
905,Lucas Bahn (D),Niagara University,40,1,6,7,0.18,12,-1
906,Brendon Michaelian (D),Mercyhurst University,18,0,7,7,0.39,6,0
907,Max Ruoho (D),Niagara University,22,0,7,7,0.32,6,-1
908,Topi Heiskanen (D),Michigan Tech,24,0,7,7,0.29,2,-2
909,Nicolas Petruolo (D),Union College,28,0,7,7,0.25,35,-6
910,Mike Vorlicky (D),University of Wisconsin,32,0,7,7,0.22,34,-2
911,Thomas Messineo (D),University of Connecticut,35,0,7,7,0.20,6,14
912,Luis Lindner (D/F),American International College,35,0,7,7,0.20,10,-6
913,Zachary Aughe (C),Lindenwood University,26,5,1,6,0.23,19,-9
914,Griffin Ness (F),University of North Dakota,27,5,1,6,0.22,12,3
915,Calvon Boots (D),RIT (Rochester Inst. of Tech.),28,5,1,6,0.21,37,2
916,Adam Flammang (RW),Bemidji State University,32,5,1,6,0.19,22,-9
917,Timofei Spitserov (RW),University of Vermont,24,4,2,6,0.25,4,-7
918,Jacob Marti (F),Air Force Academy,25,4,2,6,0.24,22,-7
919,Quinton Ong (RW),Yale University,27,4,2,6,0.22,6,-6
920,Artur Turansky (LW),Miami University (Ohio),32,4,2,6,0.19,6,-11
921,Logan Jenuwine (F),Lake Superior State University,17,3,3,6,0.35,4,-8
922,Blake Biondi (C/RW),University of Minnesota-Duluth,17,3,3,6,0.35,4,-4
923,Dallas Tulik (F),Ferris State University,18,3,3,6,0.33,22,-3
924,Ethan Harrison (F),Bentley University,20,3,3,6,0.30,2,-5
925,Matt Talarico (F),Stonehill College,20,3,3,6,0.30,6,-1
926,Joey Maziarz (D),Mercyhurst University,23,3,3,6,0.26,2,6
927,Jack Brackett (F),RPI (Rensselaer Polytech. Inst.),23,3,3,6,0.26,2,-3
928,Chris Pappas (C),Long Island University,23,3,3,6,0.26,8,-2
929,Tucker McIntosh (D),St. Lawrence University,24,3,3,6,0.25,14,-3
930,Carson Albrecht (RW),University of North Dakota,26,3,3,6,0.23,0,4
931,Desi Burgart (F),Quinnipiac University,26,3,3,6,0.23,4,-6
932,Kristaps Skrastins (C),University of New Hampshire,26,3,3,6,0.23,4,0
933,Benito Posa (F),Lake Superior State University,27,3,3,6,0.22,37,-4
934,Lynden Grandberg (F),Brown University,28,3,3,6,0.21,8,1
935,Tim Piechowski (RW),University of St. Thomas,30,3,3,6,0.20,12,-1
936,Cole Spicer (C/LW),University of Minnesota-Duluth,32,3,3,6,0.19,2,-1
937,Simon Jellus (C/LW),University of Vermont,32,3,3,6,0.19,20,-10
938,Anton Malmström (D),Bowling Green State University,33,3,3,6,0.18,16,-8
939,Ethan Gauer (D),University of St. Thomas,35,3,3,6,0.17,8,1
940,Carter Long (D),University of Vermont,36,3,3,6,0.17,4,-7
941,Christian O'Neill (C),Boston College,36,3,3,6,0.17,32,-9
942,Patrick Cozzi (RW),Colorado College,38,3,3,6,0.16,2,1
943,Bayard Hall (D),Yale University,23,2,4,6,0.26,0,3
944,Ian Pierce (D),Dartmouth College,25,2,4,6,0.24,2,-12
945,Benji Eckerle (F),Arizona State University,28,2,4,6,0.21,6,4
946,Evan Orr (D),Michigan Tech,28,2,4,6,0.21,8,2
947,Brandon Tabakin (D),Yale University,29,2,4,6,0.21,2,-9
948,Christian Felton (D),Merrimack College,32,2,4,6,0.19,14,16
949,Riley Hughes (RW),Northeastern University,32,2,4,6,0.19,18,2
950,Pierson Brandon (D),Colgate University,32,2,4,6,0.19,20,0
951,Tommy Pasanen (D),Clarkson University,32,2,4,6,0.19,38,-5
952,Austin Rook (D),Long Island University,33,2,4,6,0.18,10,-1
953,Kalle Eriksson (D),University of New Hampshire,33,2,4,6,0.18,12,-3
954,Tabor Heaslip (F),University of Connecticut,35,2,4,6,0.17,4,3
955,Noah Prokop (C),Colorado College,36,2,4,6,0.17,22,4
956,Connor Caponi (F),University of Denver,39,2,4,6,0.15,26,0
957,Brent Johnson (D),University of North Dakota,13,1,5,6,0.46,6,3
958,Evan Miller (C),RIT (Rochester Inst. of Tech.),25,1,5,6,0.24,21,2
959,Owen Ozar (F),University of Denver,27,1,5,6,0.22,10,3
960,Brayden Krieger (F),Bowling Green State University,28,1,5,6,0.21,4,-13
961,Uula Ruikka (D),Providence College,29,1,5,6,0.21,28,-2
962,Teddy Wooding (F),Yale University,30,1,5,6,0.20,0,-9
963,Jerry Harding (F),UMass,32,1,5,6,0.19,8,-5
964,Colby Enns (D),Northern Michigan University,32,1,5,6,0.19,10,14
965,Ryan Conroy (D),Yale University,32,1,5,6,0.19,28,-1
966,Nick Strom (D),RPI (Rensselaer Polytech. Inst.),35,1,5,6,0.17,6,1
967,Aidan Hreschuk (D),Boston College,35,1,5,6,0.17,20,-5
968,John Gormley (D),Long Island University,36,1,5,6,0.17,30,-6
969,Tony Malinowski (D),Minnesota State University (Mankato),37,1,5,6,0.16,4,6
970,Cam McDonald (D),Providence College,37,1,5,6,0.16,15,7
971,Tyrell Buckley (D),Canisius College,38,1,5,6,0.16,10,1
972,Cade Webber (D),Boston University,40,1,5,6,0.15,29,4
973,Jake Higgins (D),College of the Holy Cross,41,1,5,6,0.15,45,4
974,Connor Kelley (D),Providence College,21,0,6,6,0.29,10,1
975,Chase Foley (D),Colorado College,34,0,6,6,0.18,8,-11
976,Jackson Dorrington (D),Northeastern University,35,0,6,6,0.17,23,4
977,Ralfs Bergmanis (D),University of Vermont,36,0,6,6,0.17,22,-12
978,Cal Thomas (D),University of Minnesota,40,0,6,6,0.15,4,7
979,Jackson Kunz (LW),University of North Dakota,24,5,0,5,0.21,10,-5
980,Paul Maust (LW),Mercyhurst University,24,5,0,5,0.21,22,-1
981,Ryan Drkulec (F),Harvard University,14,4,1,5,0.36,8,2
982,Justin Paul (LW),St. Lawrence University,16,4,1,5,0.31,6,-4
983,John Mittelstadt (F),University of Minnesota,30,4,1,5,0.17,8,-1
984,Jaedon Leslie (F),Ohio State University,39,4,1,5,0.13,14,0
985,Brandon Lajoie (LW),University of Alaska-Anchorage,16,3,2,5,0.31,8,-4
986,Massimo-Sarantos Lombardi (C),University of Vermont,17,3,2,5,0.29,6,-6
987,Dawson Good (F),University of Vermont,22,3,2,5,0.23,6,-7
988,Ville Immonen (C),Union College,26,3,2,5,0.19,8,-6
989,Brian Adams (F),Air Force Academy,27,3,2,5,0.19,10,-6
990,Dylan Finlay (D),University of Alaska-Anchorage,27,3,2,5,0.19,14,-14
991,Brady Egan (C),Clarkson University,30,3,2,5,0.17,8,-4
992,Karl Falk (D),University of Alaska-Fairbanks,31,3,2,5,0.16,24,7
993,Jake Veilleux (D/F),University of Connecticut,32,3,2,5,0.16,2,0
994,Erik Bargholtz (F),Clarkson University,33,3,2,5,0.15,12,-2
995,Connor Milburn (F),Lake Superior State University,34,3,2,5,0.15,14,-16
996,Porter Schachle (F),University of Vermont,34,3,2,5,0.15,33,-16
997,Liam Izyk (F),Boston College,36,3,2,5,0.14,24,-7
998,Jacob Felker (F),Army (U.S. Military Academy),37,3,2,5,0.14,8,-9
999,Gustaf Westlund (C/W),Ohio State University,7,2,3,5,0.71,4,2
1000,Ethan Wolthers (F),Western Michigan University,13,2,3,5,0.38,2,2
1001,Braden Birnie (F),University of Alaska-Fairbanks,16,2,3,5,0.31,19,4
1002,Grant Ahcan (LW/RW),St. Cloud State University,19,2,3,5,0.26,10,5
1003,Chase McLane (C/RW),Penn State University,21,2,3,5,0.24,18,2
1004,Dillan Bentley (F),UMass-Lowell,22,2,3,5,0.23,4,-9
1005,Dominic Vidoli (D),Ohio State University,23,2,3,5,0.22,4,5
1006,Tanner Vescio (D),Northern Michigan University,23,2,3,5,0.22,8,9
1007,Andrew Noel (D),Ferris State University,23,2,3,5,0.22,14,3
1008,Matt Argentina (C),Boston College,24,2,3,5,0.21,4,-1
1009,Brett Pfoh (F),Bowling Green State University,24,2,3,5,0.21,10,-2
1010,Philippe Lapointe (F),University of Michigan,24,2,3,5,0.21,34,-2
1011,Hunter Toale (D),Bentley University,25,2,3,5,0.20,6,-5
1012,Shane LaVelle (F),Lindenwood University,25,2,3,5,0.20,23,-6
1013,Josh Nodler (C/RW),UMass,27,2,3,5,0.19,8,-6
1014,Levi Stauber (F),Michigan Tech,28,2,3,5,0.18,2,6
1015,Arnaud Vachon (C),Colgate University,28,2,3,5,0.18,27,-7
1016,Finn Evans (RW),University of Vermont,29,2,3,5,0.17,21,-2
1017,Dante Fantauzzi (D),Sacred Heart University,33,2,3,5,0.15,23,-1
1018,Gabe Blanchard (D),UMass-Lowell,34,2,3,5,0.15,29,2
1019,Jack Clement (D),Miami University (Ohio),36,2,3,5,0.14,30,-5
1020,Ty Murchison (D),Arizona State University,36,2,3,5,0.14,93,-1
1021,Simon Tassy (F),Minnesota State University (Mankato),15,1,4,5,0.33,0,6
1022,Zack Nazzarett (LW),Long Island University,17,1,4,5,0.29,6,-4
1023,Conor Cole (C),University of Alaska-Anchorage,24,1,4,5,0.21,8,-2
1024,Killian Kiecker-Olson (C),University of Maine,24,1,4,5,0.21,12,-2
1025,Grant Docter (D),University of St. Thomas,25,1,4,5,0.20,21,-9
1026,Tyler Rubin (D),Princeton University,26,1,4,5,0.19,18,-8
1027,Tristan Sarsland (D),Clarkson University,27,1,4,5,0.19,20,-2
1028,Mike Kennedy (D),Princeton University,28,1,4,5,0.18,14,-7
1029,Brandon Chabrier (D),University of Maine,28,1,4,5,0.18,25,0
1030,Tony Andreozzi (D),Brown University,30,1,4,5,0.17,8,-3
1031,Jack Cameron (D),Dartmouth College,30,1,4,5,0.17,16,-11
1032,Robert Cronin (F),University of New Hampshire,31,1,4,5,0.16,14,-15
1033,Zachary Plucinski (D),University of Notre Dame,31,1,4,5,0.16,27,-7
1034,Dylan Moulton (D),Miami University (Ohio),32,1,4,5,0.16,18,-18
1035,Jack Bar (D),Harvard University,32,1,4,5,0.16,31,13
1036,Luke Mobley (F),Clarkson University,33,1,4,5,0.15,38,-3
1037,Viktor Hurtig (D),Michigan State University,34,1,4,5,0.15,16,4
1038,Sebastian Dirven (D),Cornell University,34,1,4,5,0.15,23,7
1039,Brehdan Engum (D),UMass-Lowell,36,1,4,5,0.14,14,-7
1040,Carson Peters (D),University of St. Thomas,36,1,4,5,0.14,18,-7
1041,Zach Dubinsky (F),Michigan State University,37,1,4,5,0.14,21,-10
1042,Jake Boltmann (D),University of Notre Dame,37,1,4,5,0.14,48,-5
1043,Justin Jallen (F),Michigan State University,38,1,4,5,0.13,0,-8
1044,Brett Edwards (F),University of Denver,38,1,4,5,0.13,18,-5
1045,Michael Underwood (D),Michigan State University,38,1,4,5,0.13,20,-3
1046,Jay Keranen (D),University of Michigan,40,1,4,5,0.13,17,6
1047,Lincoln Erne (D),Canisius College,41,1,4,5,0.12,36,-1
1048,Jack Robilotti (D),College of the Holy Cross,41,1,4,5,0.12,55,-9
1049,Trevor LeDonne (D),University of St. Thomas,21,0,5,5,0.24,10,4
1050,Jack Smith (C/RW),University of Minnesota-Duluth,24,0,5,5,0.21,10,3
1051,James Marooney (D),Ohio State University,26,0,5,5,0.19,2,6
1052,Dalton Hunter (RW/LW),Mercyhurst University,28,0,5,5,0.18,18,-8
1053,Luca Münzenberger (D),University of Vermont,28,0,5,5,0.18,24,-9
1054,Aiden Dubinsky (D),University of Minnesota-Duluth,29,0,5,5,0.17,8,1
1055,Michael Young (D),Yale University,29,0,5,5,0.17,25,-3
1056,Brendan Budy (LW),RPI (Rensselaer Polytech. Inst.),30,0,5,5,0.17,6,-3
1057,Ellis Rickwood (C),Clarkson University,35,0,5,5,0.14,14,-3
1058,Luke Reid (D),University of New Hampshire,35,0,5,5,0.14,14,-18
1059,Adrien Bisson (D),Mercyhurst University,36,0,5,5,0.14,13,2
1060,Mason Wheeler (D),Minnesota State University (Mankato),37,0,5,5,0.14,14,9
1061,David Posma (D),Niagara University,37,0,5,5,0.14,67,-1
1062,Rylan Van Unen (F),Northern Michigan University,14,4,0,4,0.29,17,-4
1063,Aidan Connolly (C),Sacred Heart University,15,4,0,4,0.27,0,1
1064,Trevor Russell (D),Michigan Tech,16,4,0,4,0.25,10,5
1065,Morgan Winters (F),University of New Hampshire,20,4,0,4,0.20,16,-9
1066,Cade Kowalski (C/RW),Ferris State University,20,3,1,4,0.20,0,-7
1067,Austen May (D),Providence College,21,3,1,4,0.19,4,-1
1068,Nick Rhéaume (LW/C),UMass-Lowell,27,3,1,4,0.15,2,-1
1069,William Hallén (C/LW),Miami University (Ohio),29,3,1,4,0.14,28,-16
1070,Jens Richards (F),University of Vermont,30,3,1,4,0.13,6,-6
1071,Joe Berg (F),Princeton University,30,3,1,4,0.13,8,1
1072,Tyrone Bronte (RW),Michigan Tech,32,3,1,4,0.13,12,6
1073,Aaron Myers (F),Bemidji State University,35,3,1,4,0.11,6,-4
1074,Thomas Manty (F),Brown University,10,2,2,4,0.40,2,0
1075,Will Arquiett (F),St. Lawrence University,13,2,2,4,0.31,2,1
1076,Reese Farrell (F),Army (U.S. Military Academy),16,2,2,4,0.25,2,2
1077,Jonny Russell (RW),Brown University,17,2,2,4,0.24,10,0
1078,Eric Otto (F),American International College,18,2,2,4,0.22,4,0
1079,Alexander Servagno (F),Penn State University,19,2,2,4,0.21,6,0
1080,Altti Nykänen (F),RPI (Rensselaer Polytech. Inst.),20,2,2,4,0.20,17,-3
1081,Connor Gregga (F),Minnesota State University (Mankato),23,2,2,4,0.17,6,1
1082,Jack Olmstead (C/LW/RW),Miami University (Ohio),23,2,2,4,0.17,10,-11
1083,Alex Gomez (C/W),University of Alaska-Anchorage,24,2,2,4,0.17,2,-3
1084,Kalen Szeto (F),Yale University,25,2,2,4,0.16,4,-10
1085,Matt Jennings (C),University of St. Thomas,26,2,2,4,0.15,8,-9
1086,Thomas Daskas (F),Miami University (Ohio),28,2,2,4,0.14,12,-8
1087,Pat Lawn (D),Bentley University,29,2,2,4,0.14,16,2
1088,Evan Dougherty (RW),Bowling Green State University,32,2,2,4,0.13,12,-13
1089,Thomas Sinclair (C),University of Vermont,33,2,2,4,0.12,2,-7
1090,Ben Brinkman (D),University of Notre Dame,35,2,2,4,0.11,20,-8
1091,Patrick Dawson (D),Sacred Heart University,36,2,2,4,0.11,10,4
1092,Eric Parker (D),Bowling Green State University,8,1,3,4,0.50,2,3
1093,Jett Jungels (F),Northern Michigan University,13,1,3,4,0.31,6,-1
1094,Ty Pochipinski (F),Air Force Academy,14,1,3,4,0.29,8,0
1095,Tommy Bannister (F),Mercyhurst University,16,1,3,4,0.25,2,-4
1096,Justin Michaelian (F),University of Maine,20,1,3,4,0.20,2,3
1097,Tyler Williams (C),Lake Superior State University,20,1,3,4,0.20,6,3
1098,Luke Farthing (D),Ferris State University,20,1,3,4,0.20,25,-11
1099,Lucas Ölvestad (D),University of Denver,22,1,3,4,0.18,10,7
1100,Danny Weight (C),Colorado College,22,1,3,4,0.18,13,3
1101,Kirklan Irey (F),Bemidji State University,23,1,3,4,0.17,2,-5
1102,Christopher Klack (C/W),Clarkson University,25,1,3,4,0.16,8,0
1103,Dalton Messina (F),Ohio State University,25,1,3,4,0.16,10,0
1104,Chikara Hanzawa (RW),Sacred Heart University,28,1,3,4,0.14,10,-4
1105,Christian Krygier (D),Michigan State University,28,1,3,4,0.14,23,-7
1106,Tucker McRae (D),Dartmouth College,29,1,3,4,0.14,22,-13
1107,Ray Christy (F),Colorado College,30,1,3,4,0.13,6,0
1108,Jonathan Ziskie (D),Niagara University,31,1,3,4,0.13,14,-2
1109,Phip Waugh (D/C),Mercyhurst University,31,1,3,4,0.13,16,-8
1110,Ryan Helliwell (D),University of Notre Dame,31,1,3,4,0.13,19,1
1111,Philip Törnqvist (D),University of Vermont,32,1,3,4,0.13,4,-4
1112,Harrison Blaisdell (C),University of New Hampshire,32,1,3,4,0.13,10,-9
1113,Tyler Rollwagen (F),University of Nebraska-Omaha,33,1,3,4,0.12,14,0
1114,Jordan Schulting (D),Bentley University,15,0,4,4,0.27,2,-3
1115,David Ma (D),Princeton University,17,0,4,4,0.24,16,0
1116,Max Osborne (D),University of Alaska-Anchorage,19,0,4,4,0.21,4,-2
1117,Frankie Carogioiello (C),Miami University (Ohio),22,0,4,4,0.18,8,0
1118,Zackary Tonelli (F),Brown University,24,0,4,4,0.17,4,-1
1119,Marcus Walter (D),Bentley University,24,0,4,4,0.17,8,-3
1120,Steven Townley (F),Dartmouth College,30,0,4,4,0.13,4,-5
1121,Kieran O'Hearn (D),Yale University,31,0,4,4,0.13,24,-12
1122,Quinton Pepper (RW),University of St. Thomas,34,0,4,4,0.12,6,-10
1123,Hunter Lellig (D),Bowling Green State University,34,0,4,4,0.12,34,-6
1124,Owen Norton (D),Mercyhurst University,36,0,4,4,0.11,41,-13
1125,Ivan Zivlak (D),Merrimack College,38,0,4,4,0.11,2,4
1126,Alexander Krause (F),Dartmouth College,12,3,0,3,0.25,17,-3
1127,Davis Goukler (D),University of Alaska-Anchorage,17,2,1,3,0.18,6,-4
1128,Brett Chorske (C/RW),Colorado College,19,2,1,3,0.16,2,-6
1129,Aidan Carney (F),University of Maine,19,2,1,3,0.16,2,-2
1130,Hugo Esselin (C),Merrimack College,19,2,1,3,0.16,10,2
1131,Blake Wells (F),UMass-Lowell,22,2,1,3,0.14,6,1
1132,Matthew Johnson (F),University of Alaska-Anchorage,24,2,1,3,0.13,8,-8
1133,Matteo Costantini (C/LW),University of North Dakota,25,2,1,3,0.12,4,-5
1134,Blake Mesenburg (C/LW),Miami University (Ohio),25,2,1,3,0.12,12,-1
1135,Kaden Bohlsen (C),University of Nebraska-Omaha,26,2,1,3,0.12,26,-8
1136,Jordan Venegoni (F),Lake Superior State University,28,2,1,3,0.11,18,2
1137,Garrett Pinoniemi (C),University of Minnesota,29,2,1,3,0.10,4,-2
1138,Ryan Sullivan (F),UMass,32,2,1,3,0.09,8,-5
1139,Jackson Niedermayer (LW),Arizona State University,7,1,2,3,0.43,2,1
1140,Grant Hebert (C),University of Maine,8,1,2,3,0.38,0,-3
1141,Conner Jean (C),College of the Holy Cross,11,1,2,3,0.27,4,-3
1142,Bram Scheerer (LW),Union College,12,1,2,3,0.25,10,2
1143,Luke Bast (D),University of North Dakota,13,1,2,3,0.23,10,-10
1144,Austin Pick (F),Stonehill College,15,1,2,3,0.20,2,0
1145,Hunter Andrew (F),Canisius College,15,1,2,3,0.20,10,-3
1146,Kyler Kovich (LW),Cornell University,16,1,2,3,0.19,4,3
1147,Matthew Pimental (F),Stonehill College,16,1,2,3,0.19,8,-3
1148,Daniel Baldassarra (C),Long Island University,17,1,2,3,0.18,2,2
1149,Brendan Clark (F),Brown University,18,1,2,3,0.17,8,-2
1150,Kaleb Ergang (RW),Ferris State University,19,1,2,3,0.16,10,-8
1151,Thomas Horak (F),Stonehill College,20,1,2,3,0.15,23,-4
1152,Mitch Andres (D),Boston College,21,1,2,3,0.14,0,1
1153,Mitchell Becker (D),UMass-Lowell,21,1,2,3,0.14,8,2
1154,Owen Murray (D),UMass,21,1,2,3,0.14,12,-12
1155,Michael Martignetti (D),Stonehill College,23,1,2,3,0.13,12,2
1156,Eric Linell (C/RW),Bentley University,25,1,2,3,0.12,6,-14
1157,Luke Johnson (LW/C),University of Minnesota-Duluth,25,1,2,3,0.12,11,-2
1158,Joe Leahy (D),University of Vermont,25,1,2,3,0.12,27,-4
1159,Trevor Smith (C),Army (U.S. Military Academy),27,1,2,3,0.11,8,-2
1160,Nolan Sawchuk (D),University of St. Thomas,28,1,2,3,0.11,6,0
1161,Xavier Lapointe (D),RIT (Rochester Inst. of Tech.),28,1,2,3,0.11,19,-3
1162,Kieran Ruscheinski (D),Lindenwood University,29,1,2,3,0.10,20,-5
1163,Charlie Spence (D),College of the Holy Cross,30,1,2,3,0.10,12,4
1164,Luke Robinson (D),Air Force Academy,32,1,2,3,0.09,30,-11
1165,Tommy Middleton (F),Colorado College,33,1,2,3,0.09,8,0
1166,Tucker Hodgson (D),Bentley University,33,1,2,3,0.09,35,-9
1167,Brady Berard (C),Providence College,34,1,2,3,0.09,8,3
1168,Tim Clifton (C),Sacred Heart University,34,1,2,3,0.09,8,0
1169,Luke LaMaster (D),University of Wisconsin,34,1,2,3,0.09,37,-7
1170,William Magnuson (D),Bemidji State University,35,1,2,3,0.09,4,-6
1171,Elliott McDermott (D),UMass,35,1,2,3,0.09,10,2
1172,Kevin Anderson (F),Princeton University,9,0,3,3,0.33,0,2
1173,Luke Johnson (D),Providence College,12,0,3,3,0.25,0,-2
1174,Patrik Satosaari (D),Bemidji State University,12,0,3,3,0.25,0,-3
1175,Xavier Alexandre Jean-Louis (D),University of Alaska-Fairbanks,13,0,3,3,0.23,4,4
1176,Ethan Benz (F),Union College,18,0,3,3,0.17,4,0
1177,Ryan Rosborough (F),St. Cloud State University,19,0,3,3,0.16,0,2
1178,Oliver MacDonald (F),Western Michigan University,19,0,3,3,0.16,6,-1
1179,Alex Murray (D),Miami University (Ohio),19,0,3,3,0.16,10,0
1180,Charlie Strobel (C),University of Minnesota,20,0,3,3,0.15,2,-3
1181,Vincent Corcoran (D),Bemidji State University,20,0,3,3,0.15,4,0
1182,Nicolas Ardanaz (D),RPI (Rensselaer Polytech. Inst.),20,0,3,3,0.15,8,-11
1183,Nathan Kelly (D),Union College,22,0,3,3,0.14,0,-2
1184,Santeri Hartikainen (C/RW),Long Island University,22,0,3,3,0.14,4,-8
1185,Matthew Vermaeten (F),Canisius College,22,0,3,3,0.14,4,-1
1186,Samuel Duerr (D),University of Maine,22,0,3,3,0.14,8,-2
1187,Spencer Schneider (F),Bowling Green State University,24,0,3,3,0.13,8,-10
1188,Ryan Sorkin (F),Dartmouth College,25,0,3,3,0.12,25,-9
1189,Zane Demsey (D),Miami University (Ohio),25,0,3,3,0.12,33,-3
1190,Joseph Pierce (D),University of Minnesota-Duluth,26,0,3,3,0.12,8,-6
1191,Dylan Herzog (D),Yale University,26,0,3,3,0.12,16,-18
1192,Zach Faremouth (F),Ferris State University,27,0,3,3,0.11,22,0
1193,Henry Wagner (LW),Yale University,29,0,3,3,0.10,12,-9
1194,Cade Alami (D),Boston College,29,0,3,3,0.10,21,-4
1195,Brett Roloson (F),Lake Superior State University,30,0,3,3,0.10,4,-13
1196,Nico Somerville (D),American International College,30,0,3,3,0.10,18,-4
1197,Connor Sweeney (F),University of New Hampshire,34,0,3,3,0.09,6,-4
1198,Ryan O'Connell (D),Michigan Tech,35,0,3,3,0.09,14,-3
1199,John Gelatt (F),College of the Holy Cross,38,0,3,3,0.08,19,-15
1200,Seth Fyten (F),Bowling Green State University,7,2,0,2,0.29,6,-2
1201,Trym Løkkeberg (C),Dartmouth College,14,2,0,2,0.14,4,-1
1202,Trevor Griebel (D/F),Merrimack College,16,2,0,2,0.13,10,1
1203,Adam Jeffery (LW),RIT (Rochester Inst. of Tech.),16,2,0,2,0.13,15,3
1204,James McIsaac (C/RW),RPI (Rensselaer Polytech. Inst.),16,2,0,2,0.13,23,-10
1205,Mark Gallant (F),Dartmouth College,21,2,0,2,0.10,2,-8
1206,Matthew Hayami (C),Princeton University,26,2,0,2,0.08,0,0
1207,Stefan Owens (F),UMass-Lowell,26,2,0,2,0.08,2,-1
1208,Ryan Carmichael (D/F),Yale University,31,2,0,2,0.06,12,1
1209,Jack Lagerstrom (D),Cornell University,7,1,1,2,0.29,4,1
1210,Michael Citara (RW),Providence College,8,1,1,2,0.25,2,-4
1211,Nikita Borodayenko (F),Merrimack College,8,1,1,2,0.25,5,0
1212,Jake Black (F),University of Connecticut,9,1,1,2,0.22,0,1
1213,Charlie Schoen (RW),Arizona State University,9,1,1,2,0.22,0,1
1214,Wyatt Schingoethe (C),Western Michigan University,9,1,1,2,0.22,2,3
1215,Tanner Edwards (LW/C),Minnesota State University (Mankato),10,1,1,2,0.20,4,-1
1216,Blake Bride (RW),Air Force Academy,10,1,1,2,0.20,6,-1
1217,Ryan King (C/LW),Stonehill College,10,1,1,2,0.20,8,-4
1218,Brian Carrabes (F),Boston University,11,1,1,2,0.18,0,1
1219,Gustav Müller (F),Long Island University,11,1,1,2,0.18,2,-2
1220,Mikey Adamson (D),UMass,11,1,1,2,0.18,4,0
1221,Andrew Kangas (F),University of St. Thomas,11,1,1,2,0.18,6,-3
1222,Oliver Tarr (RW),Canisius College,13,1,1,2,0.15,4,-6
1223,Joe Solimine (C),College of the Holy Cross,13,1,1,2,0.15,5,1
1224,Matt Thomson (LW),Bentley University,13,1,1,2,0.15,19,-1
1225,Anthony Cipollone (F),Quinnipiac University,14,1,1,2,0.14,0,1
1226,Ryan Upson (F),Bentley University,14,1,1,2,0.14,4,1
1227,Ty Smilanic (C),University of Wisconsin,14,1,1,2,0.14,7,-8
1228,Nick Trela (F),St. Lawrence University,15,1,1,2,0.13,2,-3
1229,Zach Michaelis (C),Northern Michigan University,15,1,1,2,0.13,2,-2
1230,Dylan Schuett (C),Long Island University,16,1,1,2,0.13,10,-5
1231,Brett Willits (C),Northern Michigan University,16,1,1,2,0.13,10,-3
1232,Cameron Mannion (D),Stonehill College,17,1,1,2,0.12,6,7
1233,Jacob Badal (LW),Ferris State University,18,1,1,2,0.11,2,-5
1234,T.J. Schweighardt (D),UMass-Lowell,18,1,1,2,0.11,2,-4
1235,Max Neill (LW),Lindenwood University,19,1,1,2,0.11,17,-12
1236,Finlay Williams (F),University of Notre Dame,22,1,1,2,0.09,6,1
1237,Tanner Main (D),Bentley University,22,1,1,2,0.09,10,-10
1238,Philippe Jacques (C),RIT (Rochester Inst. of Tech.),22,1,1,2,0.09,12,-1
1239,Cameron Gendron (F),University of New Hampshire,23,1,1,2,0.09,4,-10
1240,Noah Ellis (D),UMass,23,1,1,2,0.09,6,6
1241,Danny Ciccarello (F),RPI (Rensselaer Polytech. Inst.),24,1,1,2,0.08,8,-11
1242,Sebastian Tamburro (LW),Colgate University,25,1,1,2,0.08,4,-6
1243,Eric Huss (F),Army (U.S. Military Academy),26,1,1,2,0.08,4,-8
1244,Nick Marciano (D),Princeton University,26,1,1,2,0.08,12,3
1245,Conor Lovett (F),University of New Hampshire,29,1,1,2,0.07,16,-7
1246,Kaelan Taylor (D),Clarkson University,29,1,1,2,0.07,21,-7
1247,Jake Beaune (D),Mercyhurst University,30,1,1,2,0.07,22,-2
1248,Hank Kempf (D),Cornell University,31,1,1,2,0.06,10,12
1249,Robby Drazner (D),Miami University (Ohio),31,1,1,2,0.06,23,-2
1250,Sean Vlasich (D),Army (U.S. Military Academy),32,1,1,2,0.06,4,-6
1251,Artyom Borshyov (D),Lake Superior State University,33,1,1,2,0.06,10,-15
1252,Andrew Garby (D),Army (U.S. Military Academy),34,1,1,2,0.06,16,-12
1253,Cooper Haar (LW),Canisius College,4,0,2,2,0.50,4,-4
1254,Dylan Lugris (F),Penn State University,8,0,2,2,0.25,0,0
1255,Niko Jovanovic (C/LW),University of Notre Dame,8,0,2,2,0.25,2,0
1256,John Druskinis (D),University of Michigan,8,0,2,2,0.25,9,2
1257,A.J. Casperson (D),Long Island University,8,0,2,2,0.25,10,1
1258,Lucas Coon (F),Air Force Academy,9,0,2,2,0.22,2,-3
1259,Evan McIntyre (D),Ohio State University,10,0,2,2,0.20,2,3
1260,Timothy Heinke (RW),Quinnipiac University,10,0,2,2,0.20,4,1
1261,Nick Unruh (F),Dartmouth College,11,0,2,2,0.18,0,-5
1262,Colby MacArthur (RW),Union College,11,0,2,2,0.18,0,-3
1263,Matthew Allen (C),Union College,11,0,2,2,0.18,6,0
1264,Will Margel (W/C),University of New Hampshire,12,0,2,2,0.17,0,-3
1265,Grant Anderson (D),Sacred Heart University,13,0,2,2,0.15,2,1
1266,George Grannis (F),Clarkson University,16,0,2,2,0.13,2,0
1267,Alexander Nordstrom (F),Michigan Tech,16,0,2,2,0.13,4,3
1268,Cole Craft (RW),Lake Superior State University,17,0,2,2,0.12,4,-6
1269,Liam Dennison (D),Merrimack College,17,0,2,2,0.12,21,5
1270,Jasper Lester (D),Air Force Academy,18,0,2,2,0.11,6,-3
1271,Cade Neilson (C),University of Alaska-Fairbanks,18,0,2,2,0.11,8,-3
1272,Dawson Bruneski (D),University of Maine,19,0,2,2,0.11,8,1
1273,Nick Donato (D),Miami University (Ohio),20,0,2,2,0.10,6,-10
1274,Kennedy O'Connor (D),UMass,21,0,2,2,0.10,2,-2
1275,Kent Anderson (D),University of Denver,22,0,2,2,0.09,4,3
1276,Jaxson Ezman (F),Princeton University,22,0,2,2,0.09,41,-2
1277,Kyle Aucoin (D),Harvard University,24,0,2,2,0.08,4,-4
1278,Tyler Spott (D),Northeastern University,24,0,2,2,0.08,16,4
1279,Adam Arvedson (D),Merrimack College,26,0,2,2,0.08,6,1
1280,Garrett Daly (D),University of St. Thomas,26,0,2,2,0.08,37,0
1281,Sean Keohan (D),Dartmouth College,27,0,2,2,0.07,6,-10
1282,Jackson MacNab (RW),College of the Holy Cross,30,0,2,2,0.07,4,-6
1283,Grant Hindman (D),Lake Superior State University,34,0,2,2,0.06,18,-8
1284,Bryan Huggins (D),Lake Superior State University,34,0,2,2,0.06,24,-1
1285,C.J. Regula (D),Ohio State University,35,0,2,2,0.06,16,2
1286,Campbell Cichosz (D),Minnesota State University (Mankato),36,0,2,2,0.06,6,0
1287,Michael Hodge (F),Union College,2,1,0,1,0.50,0,0
1288,Brendan Studioso (RW),Arizona State University,3,1,0,1,0.33,15,0
1289,Alex Mella (LW),Northeastern University,4,1,0,1,0.25,2,1
1290,Ben Copeland (C),Penn State University,5,1,0,1,0.20,0,2
1291,Zachary Power (C),University of Alaska-Fairbanks,5,1,0,1,0.20,4,3
1292,Andrew Amousse (C),American International College,6,1,0,1,0.17,0,1
1293,Mike Egan (F),Niagara University,6,1,0,1,0.17,0,-2
1294,Brady MacDonald (D),Dartmouth College,7,1,0,1,0.14,0,-1
1295,Austin McCarthy (F),Ferris State University,7,1,0,1,0.14,0,-3
1296,John Sladic (F),Miami University (Ohio),7,1,0,1,0.14,0,-3
1297,Brenden Olson (D),Minnesota State University (Mankato),7,1,0,1,0.14,4,1
1298,Jack Seymour (RW),College of the Holy Cross,8,1,0,1,0.13,4,-4
1299,Matthew Fawcett (LW),University of Maine,10,1,0,1,0.10,0,-7
1300,Cooper Connell (F),Bentley University,10,1,0,1,0.10,4,-2
1301,Linden Alger (D),UMass,11,1,0,1,0.09,6,1
1302,Brian Silver (D),Miami University (Ohio),11,1,0,1,0.09,6,0
1303,Luke Erickson (D),St. Lawrence University,11,1,0,1,0.09,10,-2
1304,Caleb Huffman (D),University of Alaska-Anchorage,12,1,0,1,0.08,6,-3
1305,Ethan Aucoin (F),St. Cloud State University,12,1,0,1,0.08,19,0
1306,Colton Trumbla (LW),RIT (Rochester Inst. of Tech.),14,1,0,1,0.07,0,-2
1307,Marcus Pedersen (RW/LW),Michigan Tech,16,1,0,1,0.06,0,0
1308,Nate Morgan (F),Dartmouth College,16,1,0,1,0.06,2,-3
1309,Adam Dawe (RW/C),University of Connecticut,16,1,0,1,0.06,8,-6
1310,Braidan Simmons-Fischer (D),University of St. Thomas,19,1,0,1,0.05,28,-4
1311,Ashton Fry (F),St. Lawrence University,20,1,0,1,0.05,40,-3
1312,Henri Schreifels (F),RPI (Rensselaer Polytech. Inst.),21,1,0,1,0.05,8,-9
1313,Seamus Powell (D),Boston College,21,1,0,1,0.05,15,-3
1314,Kienan Draper (RW),University of Michigan,23,1,0,1,0.04,24,0
1315,Anthony Kehrer (D),University of Wisconsin,26,1,0,1,0.04,14,-10
1316,Anthony Stark (D),Colgate University,30,1,0,1,0.03,4,5
1317,Cam Knuble (F),Western Michigan University,30,1,0,1,0.03,4,-1
1318,Austin Wong (RW/C),Harvard University,30,1,0,1,0.03,28,-8
1319,Dylan Robbins (F),Sacred Heart University,31,1,0,1,0.03,6,0
1320,Mason Langenbrunner (D),Harvard University,33,1,0,1,0.03,22,1
1321,Filip Karlsson Tägtström (C),Merrimack College,2,0,1,1,0.50,0,1
1322,Kevin Sadovski (D),Merrimack College,2,0,1,1,0.50,0,1
1323,Garrett Sundquist (D),Providence College,2,0,1,1,0.50,0,2
1324,Tyler Kostelecky (F),Long Island University,4,0,1,1,0.25,0,-2
1325,Will Hilfiker (D),University of Alaska-Fairbanks,5,0,1,1,0.20,0,1
1326,Will Traeger (C),Boston College,5,0,1,1,0.20,0,0
1327,Brendan Kennette (D),Sacred Heart University,5,0,1,1,0.20,8,1
1328,Stephen Willey (LW),Army (U.S. Military Academy),6,0,1,1,0.17,0,-1
1329,Powell Connor (D),Michigan State University,6,0,1,1,0.17,2,4
1330,Rowan Miller (F),University of Alaska-Anchorage,6,0,1,1,0.17,4,-1
1331,Robby Newton (F),University of Wisconsin,7,0,1,1,0.14,0,-1
1332,Noah Wakeford (F),Brown University,7,0,1,1,0.14,0,-1
1333,Joe Hankinson (F),University of New Hampshire,7,0,1,1,0.14,2,-3
1334,Joshua Wildauer (C),Lake Superior State University,7,0,1,1,0.14,2,-2
1335,Carl Fish (D),University of Minnesota,7,0,1,1,0.14,2,2
1336,Alex Konovalov (F),Princeton University,7,0,1,1,0.14,4,-2
1337,Brett Oberle (F/D),Air Force Academy,7,0,1,1,0.14,4,-3
1338,Jace Foskey (D),Harvard University,8,0,1,1,0.13,0,3
1339,Owen Nolan (D),Army (U.S. Military Academy),8,0,1,1,0.13,2,-3
1340,Cam Gaudette (D),Northeastern University,8,0,1,1,0.13,4,-1
1341,John Lundy (F),American International College,9,0,1,1,0.11,2,-3
1342,Jackson Wozniak (F),Lindenwood University,9,0,1,1,0.11,4,-6
1343,Johnny Wescoe (F),Niagara University,10,0,1,1,0.10,2,-3
1344,Tyler Gaulin (F),Mercyhurst University,10,0,1,1,0.10,6,-1
1345,Kendrick Frost (LW),Army (U.S. Military Academy),11,0,1,1,0.09,0,2
1346,Shay Donovan (D),University of Wisconsin,11,0,1,1,0.09,2,-1
1347,Nate Schweitzer (D),Colorado College,11,0,1,1,0.09,4,-2
1348,Drew Vieten (F),Niagara University,11,0,1,1,0.09,9,0
1349,Tanner Hickey (D),Arizona State University,11,0,1,1,0.09,17,0
1350,Anthony Mollica (D),St. Lawrence University,12,0,1,1,0.08,2,-3
1351,Sam Watson (F),Lindenwood University,12,0,1,1,0.08,4,-5
1352,Keegan Langefels (D),Canisius College,12,0,1,1,0.08,4,-5
1353,Will Schimek (D),Providence College,12,0,1,1,0.08,6,-1
1354,Jack Collins (F),UMass-Lowell,12,0,1,1,0.08,19,2
1355,Owen Neuharth (C),Colgate University,13,0,1,1,0.08,0,-2
1356,Tyler Haskins (F),University of Denver,13,0,1,1,0.08,0,1
1357,Luke Mountain (F),University of Vermont,13,0,1,1,0.08,2,-1
1358,Andrius Kulbis-Marino (D),Sacred Heart University,13,0,1,1,0.08,4,-1
1359,Jimmy Darby (D),University of Alaska-Anchorage,13,0,1,1,0.08,4,1
1360,Reggie Millette (F),American International College,13,0,1,1,0.08,10,-3
1361,Ryan Tattle (F),University of Connecticut,13,0,1,1,0.08,10,-1
1362,Richard Hall (D),Stonehill College,13,0,1,1,0.08,13,-2
1363,Cam Mitchell (LW),University of Nebraska-Omaha,14,0,1,1,0.07,0,1
1364,Jack DeBoer (C),Niagara University,14,0,1,1,0.07,0,1
1365,Hunter McCoy (F),Army (U.S. Military Academy),14,0,1,1,0.07,2,-5
1366,Jack Babbage (D),University of New Hampshire,14,0,1,1,0.07,4,-4
1367,Xan Gurney (D),Long Island University,14,0,1,1,0.07,8,-6
1368,Luke Perunovich (D),University of St. Thomas,14,0,1,1,0.07,15,-9
1369,Drew Gardner (D),Stonehill College,14,0,1,1,0.07,17,0
1370,Jude Brower (D),Army (U.S. Military Academy),15,0,1,1,0.07,0,-2
1371,Logan Acheson (D),Bemidji State University,15,0,1,1,0.07,2,1
1372,Michael Outzen (F),Northeastern University,16,0,1,1,0.06,0,1
1373,Wyatt Schlaht (F),Brown University,16,0,1,1,0.06,2,-6
1374,Bobby Metz (D),Colgate University,16,0,1,1,0.06,4,1
1375,Andrew Kruse (D),Air Force Academy,16,0,1,1,0.06,6,-6
1376,Rory Herrman (F),RPI (Rensselaer Polytech. Inst.),16,0,1,1,0.06,10,-5
1377,Jonathan Balah (D),College of the Holy Cross,17,0,1,1,0.06,2,3
1378,Ryan Coughlin (F),Mercyhurst University,17,0,1,1,0.06,6,-5
1379,Jeremy Gervais (D),Lake Superior State University,17,0,1,1,0.06,8,0
1380,Xavier Henry (D),University of Vermont,18,0,1,1,0.06,2,-3
1381,Brandon Stanley (F),Niagara University,19,0,1,1,0.05,0,-5
1382,Jordan Wishman (D),Niagara University,19,0,1,1,0.05,20,5
1383,Jack Lyons (D),Canisius College,20,0,1,1,0.05,2,1
1384,Matt Kinash (F),University of Alaska-Anchorage,20,0,1,1,0.05,16,-6
1385,Blake Dangos (D),Arizona State University,20,0,1,1,0.05,18,-9
1386,Dylan Davies (D/F),RPI (Rensselaer Polytech. Inst.),21,0,1,1,0.05,23,2
1387,Michael Mastrodomenico (D),University of Notre Dame,22,0,1,1,0.05,12,6
1388,Caden Lewandowski (D),Clarkson University,23,0,1,1,0.04,0,7
1389,Wyllum Deveaux (F),Harvard University,25,0,1,1,0.04,2,0
1390,Luke Albert (D),Brown University,25,0,1,1,0.04,12,0
1391,Carter Belitski (F),University of Alaska-Anchorage,25,0,1,1,0.04,14,-7
1392,Tyrell Boucher (D),Northern Michigan University,28,0,1,1,0.04,12,5
1393,Will Francis (D),University of Minnesota-Duluth,28,0,1,1,0.04,22,-1
1394,Lane Brockhoff (D),Niagara University,30,0,1,1,0.03,31,-2
1395,Arvid Henrikson (D),Lake Superior State University,31,0,1,1,0.03,36,-10
1396,Dean Bauchiero (W),Brown University,0,0,0,0,0.00,0,0
1397,Garrett Wait (LW),UMass,0,0,0,0,0.00,0,0
1398,Dorian Dawson (D),University of Alaska-Anchorage,0,0,0,0,0.00,0,0
1399,Nick Grimaldi (F),Ferris State University,0,0,0,0,0.00,0,0
1400,Matt Staudacher (D),University of Minnesota,0,0,0,0,0.00,0,0
1401,Barrett Brooks (RW),Western Michigan University,0,0,0,0,0.00,0,0
1402,Mark D'Agostino (F),University of Connecticut,0,0,0,0,0.00,0,0
1403,Tanner Latsch (C),Northern Michigan University,0,0,0,0,0.00,0,0
1404,Cole Burtch (LW),Western Michigan University,0,0,0,0,0.00,0,0
1405,Oliver Bezick (D),Michigan Tech,0,0,0,0,0.00,0,0
1406,Jack Powell (D),Bemidji State University,0,0,0,0,0.00,0,0
1407,Jesper Tarkiainen (RW),University of Vermont,0,0,0,0,0.00,0,0
1408,Michael Holland (F),Miami University (Ohio),0,0,0,0,0.00,0,0
1409,Jack Dempsey (F),Boston College,0,0,0,0,0.00,0,0
1410,Andrew Gotts (F),Stonehill College,0,0,0,0,0.00,0,0
1411,Jimmy Rayhill (D),Cornell University,0,0,0,0,0.00,0,0
1412,Harry Meirowitz (D),Brown University,0,0,0,0,0.00,0,0
1413,Jack Hoey (C),Colgate University,0,0,0,0,0.00,0,0
1414,Ricards Landmanis (D),University of Alaska-Fairbanks,0,0,0,0,0.00,0,0
1415,Kyler Kleven (C),University of Minnesota-Duluth,0,0,0,0,0.00,0,0
1416,Quinn Rudrud (F),University of Alaska-Fairbanks,0,0,0,0,0.00,0,0
1417,Spencer Evans (D),Brown University,0,0,0,0,0.00,0,0
1418,Matthew Campbell (D),Quinnipiac University,0,0,0,0,0.00,0,0
1419,Charlie Campbell (F),Clarkson University,0,0,0,0,0.00,0,0
1420,Dane Montgomery (D/RW),University of North Dakota,0,0,0,0,0.00,0,0
1421,Bennett Zmolek (D),Minnesota State University (Mankato),0,0,0,0,0.00,0,0
1422,Luke Khozozian (F),Harvard University,0,0,0,0,0.00,0,0
1423,Zane Kindrachuk (F),Niagara University,0,0,0,0,0.00,0,0
1424,Roc Truman (F),UMass-Lowell,0,0,0,0,0.00,0,0
1425,Josh Phillips (D),Union College,0,0,0,0,0.00,0,0
1426,Jake Sacratini (RW),American International College,0,0,0,0,0.00,0,0
1427,Alec Capstick (D),Miami University (Ohio),0,0,0,0,0.00,0,0
1428,Carver Watson (D),Mercyhurst University,0,0,0,0,0.00,0,0
1429,Hunter Weiss (D),University of Notre Dame,0,0,0,0,0.00,0,0
1430,Matt Cameron (F),Niagara University,0,0,0,0,0.00,0,0
1431,Peter Muzyka (D),Cornell University,0,0,0,0,0.00,0,0
1432,Nolan Cunningham (D),Air Force Academy,0,0,0,0,0.00,0,0
1433,Aidan Metcalfe (D),University of Connecticut,0,0,0,0,0.00,0,0
1434,Tommy Lyons (F),Harvard University,0,0,0,0,0.00,0,0
1435,Louis Helsen (D),RPI (Rensselaer Polytech. Inst.),0,0,0,0,0.00,0,0
1436,Theo Thrun (F),Western Michigan University,0,0,0,0,0.00,0,0
1437,Hunter McCurdy (D),American International College,0,0,0,0,0.00,0,0
1438,Dalton Weigel (D),Air Force Academy,0,0,0,0,0.00,0,0
1439,Samuel Sjölund (D),Western Michigan University,0,0,0,0,0.00,0,0
1440,Trevor Adams (F),Union College,0,0,0,0,0.00,0,0
1441,Spencer DenBeste (F),Lake Superior State University,0,0,0,0,0.00,0,0
1442,Cade Penney (D),University of New Hampshire,0,0,0,0,0.00,0,0
1443,Ethan Leyh (F),Bentley University,0,0,0,0,0.00,0,0
1444,Tyler Nasca (D),Mercyhurst University,0,0,0,0,0.00,0,0
1445,Nicholas Kent (D),Mercyhurst University,0,0,0,0,0.00,0,0
1446,Kyle Furey (D),Northeastern University,1,0,0,0,0.00,0,0
1447,Alex Power (C),Quinnipiac University,1,0,0,0,0.00,0,1
1448,Ryan Robinson (LW),Arizona State University,1,0,0,0,0.00,0,0
1449,Lucas Jones (D),University of Vermont,1,0,0,0,0.00,0,-1
1450,Brayden Morrison (C/LW),University of Wisconsin,1,0,0,0,0.00,0,0
1451,Jeppe Urup Mogensen (D),Sacred Heart University,1,0,0,0,0.00,0,0
1452,Blaine Warnert (F),University of St. Thomas,1,0,0,0,0.00,0,-1
1453,Frank Dovorany (D),Michigan Tech,1,0,0,0,0.00,0,0
1454,Pat Sunderland (F),Stonehill College,1,0,0,0,0.00,0,0
1455,Chase McInnis (F),Northeastern University,1,0,0,0,0.00,0,0
1456,Jack O'Brien (D),Cornell University,1,0,0,0,0.00,0,0
1457,Andrew Seaman (F),Union College,1,0,0,0,0.00,0,0
1458,Mason Kruger (D),Lindenwood University,1,0,0,0,0.00,0,-1
1459,Jason Marsella (D),Yale University,1,0,0,0,0.00,0,0
1460,Nikolai Charchenko (D),Colorado College,1,0,0,0,0.00,0,-2
1461,Austin Jouppi (F),Bemidji State University,1,0,0,0,0.00,0,0
1462,Grant Porter (F),Providence College,1,0,0,0,0.00,0,1
1463,Tyler Shea (LW),University of Michigan,1,0,0,0,0.00,0,0
1464,Tom Richter (F),Union College,1,0,0,0,0.00,0,0
1465,Cal Dybicz (D),Michigan State University,1,0,0,0,0.00,0,0
1466,Sean Driscoll (D),Boston University,1,0,0,0,0.00,0,1
1467,Chad Sasaki (D),Colorado College,1,0,0,0,0.00,0,0
1468,Carson Dyck (F),Penn State University,2,0,0,0,0.00,0,-1
1469,Kenny Johnson (D),Penn State University,2,0,0,0,0.00,0,0
1470,Luke Kron (C),University of St. Thomas,2,0,0,0,0.00,0,-1
1471,Anthony Messuri (F),Northeastern University,2,0,0,0,0.00,0,0
1472,Devlin O'Brien (LW),Merrimack College,2,0,0,0,0.00,0,1
1473,Reid Leibold (F),RPI (Rensselaer Polytech. Inst.),2,0,0,0,0.00,0,-1
1474,Eric DeDobbelaer (C/RW),UMass,2,0,0,0,0.00,0,0
1475,Mark Cooper (D),UMass-Lowell,2,0,0,0,0.00,0,0
1476,Jojo Tanaka-Campbell (F),Yale University,2,0,0,0,0.00,0,0
1477,Adisen Brueck (F),Lindenwood University,2,0,0,0,0.00,0,-3
1478,Drake Usher (D),Air Force Academy,2,0,0,0,0.00,0,0
1479,Chrystopher Collin (C/LW),Bowling Green State University,2,0,0,0,0.00,0,0
1480,Kyle Haskins (C),Michigan State University,2,0,0,0,0.00,0,-1
1481,Josh Bohlin (F),Army (U.S. Military Academy),2,0,0,0,0.00,0,0
1482,Isaac MacLeod (RW),St. Lawrence University,3,0,0,0,0.00,0,-1
1483,Ryan Nolan (F),Michigan State University,3,0,0,0,0.00,0,-1
1484,Liam Connors (F),College of the Holy Cross,3,0,0,0,0.00,0,1
1485,Noah Hackett (F),Niagara University,3,0,0,0,0.00,0,0
1486,Kasper Vähärautio (D),Michigan Tech,3,0,0,0,0.00,0,0
1487,Jakob Peterson (D),Northern Michigan University,3,0,0,0,0.00,2,-1
1488,Ryan Lovett (F),Dartmouth College,3,0,0,0,0.00,2,-1
1489,Zachary Purcell (F),American International College,3,0,0,0,0.00,2,0
1490,Tucker Hartmann (D),Yale University,3,0,0,0,0.00,2,-3
1491,Christian MacDougall (F),Canisius College,3,0,0,0,0.00,4,0
1492,Blais Richartz (F),Michigan Tech,4,0,0,0,0.00,0,-1
1493,Jack Page (D),Boston University,4,0,0,0,0.00,0,1
1494,Thomas Jarman (D),Boston University,4,0,0,0,0.00,0,-2
1495,Adam Tisdale (C),University of Alaska-Anchorage,4,0,0,0,0.00,2,-5
1496,Grayson Dietrich (C/LW),American International College,4,0,0,0,0.00,2,-1
1497,Casper Söderling (D),American International College,4,0,0,0,0.00,2,0
1498,Matteo Pecchia (LW),University of Alaska-Fairbanks,4,0,0,0,0.00,2,-1
1499,Eriks Zohovs (C),University of Alaska-Fairbanks,4,0,0,0,0.00,5,-1
1500,Brendan Miles (D),University of Michigan,5,0,0,0,0.00,0,-2
