ID,Player,Team,GP,G,A,TP,PPG,PIM,PM
1,Jack Devine (RW),University of Denver,44,13,44,57,1.30,32,16
2,Aidan Thompson (C/LW),University of Denver,44,21,34,55,1.25,26,16
3,Liam McLinskey (RW/LW),College of the Holy Cross,40,24,30,54,1.35,18,5
4,Aiden Fink (RW),Penn State University,40,23,30,53,1.33,12,15
5,Isaac Howard (LW),Michigan State University,37,26,26,52,1.41,10,19
6,Ayrton Martino (LW),Clarkson University,39,25,26,51,1.31,8,11
7,Jimmy Snuggerud (RW),University of Minnesota,40,24,27,51,1.28,29,13
8,Cole O'Hara (RW),UMass,40,22,29,51,1.28,14,21
9,Quinn Hutson (RW),Boston University,38,23,27,50,1.32,33,17
10,Ryan Leonard (C),Boston College,37,30,19,49,1.32,46,30
11,Gabe Perreault (RW),Boston College,37,16,32,48,1.30,25,28
12,Cole Hutson (D),Boston University,39,14,34,48,1.23,64,5
13,Zeev Buium (D),University of Denver,41,13,35,48,1.17,44,17
14,Joey Muldowney (RW),University of Connecticut,39,29,18,47,1.21,12,27
15,Alex Bump (LW),Western Michigan University,42,23,24,47,1.12,14,11
16,Liam Malmquist (F),University of St. Thomas,38,20,25,45,1.18,8,18
17,Carter King (C/LW),University of Denver,44,21,22,43,0.98,16,17
18,Jake Richard (RW/LW),University of Connecticut,34,15,28,43,1.26,16,26
19,Ethan Leyh (F),Bentley University,37,17,25,42,1.14,29,11
20,Mac Gadowsky (D),Army (U.S. Military Academy),38,16,26,42,1.11,6,5
21,Charlie Cerrato (C),Penn State University,38,15,27,42,1.11,58,16
22,Lucas Wahlin (RW/LW),University of St. Thomas,38,17,24,41,1.08,50,15
23,Jack Williams (RW/LW),Northeastern University,37,16,25,41,1.11,25,6
24,Jeremy Wilmer (LW),Quinnipiac University,38,15,26,41,1.08,4,-6
25,Hudson Schandor (C),University of Connecticut,37,10,31,41,1.11,12,21
26,Quinn Finley (LW),University of Wisconsin,37,20,20,40,1.08,31,-2
27,Cameron Lund (C/W),Northeastern University,37,18,22,40,1.08,14,1
28,Gunnarwolfe Fontaine (LW/C),Ohio State University,40,17,23,40,1.00,6,6
29,Rhett Pitlick (LW/RW),Minnesota State University (Mankato),39,13,27,40,1.03,14,32
30,Ryan Kirwan (LW/RW),Arizona State University,37,26,13,39,1.05,6,6
31,Jason Ahearn (F),Niagara University,36,19,20,39,1.08,23,6
32,Connor Kurth (F),University of Minnesota,40,18,21,39,0.98,10,31
33,Matthew Wood (LW/C),University of Minnesota,39,17,22,39,1.00,16,19
34,Cole Knuble (C/RW),University of Notre Dame,34,12,27,39,1.15,12,6
35,Trevor Hoskin (RW/C),Niagara University,36,12,27,39,1.08,12,7
36,Aydar Suniev (LW/RW),UMass,35,20,18,38,1.09,41,12
37,Artem Shlaine (C),Arizona State University,31,17,21,38,1.23,16,10
38,Tim Washe (C/LW),Western Michigan University,42,16,22,38,0.90,18,22
39,T.J. Hughes (F),University of Michigan,36,15,23,38,1.06,12,5
40,Félix Trudeau (LW),Sacred Heart University,39,15,23,38,0.97,64,1
41,Ryan Greene (C),Boston University,40,13,25,38,0.95,18,6
42,Mason Marcellus (C),Quinnipiac University,38,10,28,38,1.00,28,6
43,Lukas Sillinger (W/C),Arizona State University,35,8,30,38,1.09,12,8
44,Ryland Mosley (LW/RW),University of Wisconsin,37,18,19,37,1.00,21,-2
45,Bennett Schimek (F),Arizona State University,35,15,22,37,1.06,4,5
46,James Hagens (C/LW),Boston College,37,11,26,37,1.00,24,21
47,Cole Eiserman (LW),Boston University,39,25,11,36,0.92,27,7
48,Owen Michaels (F),Western Michigan University,42,18,18,36,0.86,6,27
49,Dylan Hryckowian (RW),Northeastern University,36,17,19,36,1.00,26,4
50,Travis Treloar (C),Quinnipiac University,38,16,20,36,0.95,4,3
51,Grant Slukynsky (C),Western Michigan University,42,10,26,36,0.86,2,19
52,Tyler Fukakusa (C),RIT (Rochester Inst. of Tech.),35,9,27,36,1.03,18,-11
53,Sam Harris (LW),University of Denver,43,23,12,35,0.81,42,14
54,Harrison Scott (C/LW),University of Maine,38,18,17,35,0.92,26,13
55,Jack Musa (F),UMass,40,18,17,35,0.88,4,18
56,Andon Cerbone (F),Quinnipiac University,38,15,20,35,0.92,16,4
57,Stiven Sardaryan (RW/C),Michigan Tech,35,11,24,35,1.00,51,3
58,Eric Pohlkamp (D),University of Denver,44,11,24,35,0.80,22,31
59,Ellis Rickwood (C),Clarkson University,39,10,25,35,0.90,22,16
60,Sam Stange (RW),University of Nebraska-Omaha,36,16,18,34,0.94,20,14
61,Brett Chorske (C/RW),Colgate University,36,15,19,34,0.94,23,-4
62,Justin Janicke (LW/C),University of Notre Dame,38,15,19,34,0.89,29,-3
63,Michael Hage (C),University of Michigan,33,13,21,34,1.03,23,-9
64,Shane Ott (F),Niagara University,35,9,25,34,0.97,10,6
65,Riley Thompson (F),Ohio State University,40,17,16,33,0.83,32,12
66,Ryan Conmy (RW),University of New Hampshire,34,15,18,33,0.97,6,-1
67,J.J. Wiebusch (F),Penn State University,40,14,19,33,0.83,14,13
68,Davis Burnside (F),Ohio State University,40,14,19,33,0.83,18,8
69,Liam Valente (LW/C),Western Michigan University,42,14,19,33,0.79,10,8
70,Oliver Moore (C),University of Minnesota,38,12,21,33,0.87,6,13
71,Ryan O'Hara (LW),Bowling Green State University,36,11,22,33,0.92,16,5
72,Dans Locmelis (C),UMass,40,8,25,33,0.83,8,16
73,Noah Beck (D),Arizona State University,37,5,28,33,0.89,28,12
74,Matthew Wilde (LW),RIT (Rochester Inst. of Tech.),27,18,14,32,1.19,24,-7
75,Sacha Boisvert (C),University of North Dakota,37,18,14,32,0.86,20,-4
76,Ryan Tattle (F),University of Connecticut,39,18,14,32,0.82,22,10
77,Matthew DiMarsico (F),Penn State University,39,17,15,32,0.82,30,12
78,Mick Thompson (LW),Harvard University,33,14,18,32,0.97,2,-5
79,Josh Groll (C/LW),Minnesota State University (Mankato),38,14,18,32,0.84,31,31
80,Sam Rinzel (D),University of Minnesota,40,10,22,32,0.80,12,20
81,Gavin Morrissey (F),University of Wisconsin,37,9,23,32,0.86,14,4
82,Ryan Walsh (C/RW),Cornell University,36,17,14,31,0.86,21,14
83,Karsen Dorwart (LW/C),Michigan State University,35,13,18,31,0.89,12,20
84,John Jaworski (F),Sacred Heart University,39,13,18,31,0.79,12,8
85,Danny Dzhaniyev (F),Penn State University,40,12,19,31,0.78,4,-3
86,Devin Phillips (F),College of the Holy Cross,34,11,20,31,0.91,6,-1
87,Matt DeBoer (W),College of the Holy Cross,40,11,20,31,0.78,46,3
88,Lucas Mercuri (C/RW),UMass,40,10,21,31,0.78,24,14
89,Glebs Prohorenkovs (F),Niagara University,37,9,22,31,0.84,16,15
90,Aiden Hansen-Bukata (D),Ohio State University,38,2,29,31,0.82,20,11
91,Cooper Gay (LW/RW),University of St. Thomas,35,19,11,30,0.86,14,6
92,Taylor Makar (LW/C),University of Maine,38,18,12,30,0.79,47,24
93,Carter Rapalje (F),Long Island University,34,17,13,30,0.88,2,-2
94,Reese Laubach (C),Penn State University,35,15,15,30,0.86,59,9
95,Andre Gasseau (C/LW),Boston College,36,15,15,30,0.83,49,23
96,Dominic James (C/LW),University of Minnesota-Duluth,35,14,16,30,0.86,20,5
97,Teddy Stiga (LW),Boston College,36,14,16,30,0.83,34,12
98,Zachary Nehring (RW),Western Michigan University,42,13,17,30,0.71,29,18
99,Kyle Smolen (F),Arizona State University,35,12,18,30,0.86,22,12
100,Aaron Schwartz (F),Quinnipiac University,38,12,18,30,0.79,2,-1
101,Shane Lachance (LW),Boston University,40,12,18,30,0.75,28,0
102,C.J. Foley (D),Dartmouth College,33,11,19,30,0.91,10,16
103,Ryan Richardson (LW),Clarkson University,38,11,19,30,0.79,16,15
104,Nick Bochen (D),Bentley University,40,9,21,30,0.75,31,15
105,Boston Buckberger (D),University of Denver,41,9,21,30,0.73,22,30
106,Matteo Giampa (RW),Canisius College,37,8,22,30,0.81,10,-10
107,Owen McLaughlin (C),University of North Dakota,38,5,25,30,0.79,6,3
108,Nikita Nikora (C/W),Dartmouth College,33,4,26,30,0.91,4,-8
109,Simon Mack (D),Penn State University,40,3,27,30,0.75,6,23
110,Iiro Hakkarainen (LW/RW),Western Michigan University,42,13,16,29,0.69,21,21
111,Ryan St. Louis (LW),Brown University,23,11,18,29,1.26,2,0
112,Josh Nadeau (RW/LW),University of Maine,37,10,19,29,0.78,14,12
113,Kenny Connors (C),UMass,40,10,19,29,0.73,6,4
114,Trey Taylor (D),Clarkson University,39,9,20,29,0.74,12,2
115,Clay Cosentino (F),Air Force Academy,40,9,20,29,0.73,23,-11
116,Caden Villegas (F),Union College,36,7,22,29,0.81,16,6
117,Colby MacArthur (RW),Union College,36,7,22,29,0.81,18,11
118,Samuel Sjölund (D),Western Michigan University,42,4,25,29,0.69,18,19
119,Mack Oliphant (D),College of the Holy Cross,36,3,26,29,0.81,4,3
120,Brandon Buhr (F),Union College,36,19,9,28,0.78,25,1
121,Robert Cronin (F),University of New Hampshire,35,17,11,28,0.80,20,-5
122,Casey Severo (C),Harvard University,33,16,12,28,0.85,4,10
123,Austin Burnevik (RW/LW),St. Cloud State University,35,13,15,28,0.80,8,-15
124,Ben Muthersbaugh (LW),Union College,36,13,15,28,0.78,31,-3
125,Reid Pabich (C),Sacred Heart University,39,13,15,28,0.72,18,13
126,David Gagnon (LW),Lindenwood University,32,11,17,28,0.88,23,1
127,Nate Hanley (C),Union College,35,10,18,28,0.80,4,-3
128,Samu Salminen (C/LW),University of Denver,44,10,18,28,0.64,24,21
129,Max Plante (C),University of Minnesota-Duluth,23,9,19,28,1.22,16,5
130,Tyler Kopff (C/LW),Brown University,32,9,19,28,0.88,12,1
131,Cy LeClerc (F),University of New Hampshire,33,8,20,28,0.85,12,-10
132,Damien Carfagna (D),Ohio State University,38,7,21,28,0.74,6,16
133,Frank Djurasevic (D),University of Maine,38,7,21,28,0.74,14,18
134,Jake Livanavage (D),University of North Dakota,38,4,24,28,0.74,12,0
135,Jack Ricketts (C),Quinnipiac University,38,20,7,27,0.71,47,22
136,Sean Chisholm (C/LW),Dartmouth College,33,15,12,27,0.82,12,4
137,Jack Stockfish (C),College of the Holy Cross,36,15,12,27,0.75,30,0
138,Dalton Bancroft (RW/LW),Cornell University,36,15,12,27,0.75,48,11
139,Mikey Adamson (D),Sacred Heart University,37,12,15,27,0.73,14,11
140,Blake Biondi (C/RW),University of Notre Dame,38,12,15,27,0.71,14,-12
141,Nik Armstrong-Kingcade (F),Bentley University,38,12,15,27,0.71,16,7
142,Jack Harvey (F),Boston University,40,11,16,27,0.68,2,12
143,Joel Määttä (C),University of Vermont,35,9,18,27,0.77,16,5
144,Charlie Stramel (C/RW),Michigan State University,37,9,18,27,0.73,26,13
145,John Prokop (D),Union College,36,8,19,27,0.75,20,12
146,Max Koskipirtti (C/W),Michigan Tech,36,7,20,27,0.75,0,-2
147,Owen Beckner (C),Colorado College,37,7,20,27,0.73,4,8
148,Evan Murr (D),Minnesota State University (Mankato),39,7,20,27,0.69,8,18
149,Brody Lamb (RW),University of Minnesota,39,17,9,26,0.67,12,1
150,Tyler Wallace (C),Niagara University,37,14,12,26,0.70,12,5
151,Max Montes (F),Ohio State University,40,14,12,26,0.65,16,3
152,Danny Nelson (C/LW),University of Notre Dame,36,13,13,26,0.72,35,-4
153,Adam Eisele (F),Minnesota State University (Mankato),37,13,13,26,0.70,49,23
154,Brendan Gorman (C),Princeton University,30,12,14,26,0.87,12,-7
155,Max Scott (F),Brown University,32,12,14,26,0.81,21,-6
156,Jayson Shaugabay (C),University of Minnesota-Duluth,36,12,14,26,0.72,4,-3
157,Alex DiPaolo (LW),Colgate University,32,11,15,26,0.81,12,-9
158,Barron Woodring (C),Army (U.S. Military Academy),38,11,15,26,0.68,12,-9
159,Chris Hedden (D),Air Force Academy,39,11,15,26,0.67,52,-16
160,Noah Laba (C),Colorado College,29,10,16,26,0.90,25,10
161,Ty Gallagher (D),Colorado College,37,9,17,26,0.70,12,7
162,Charlie Russell (F),University of Maine,35,7,19,26,0.74,24,11
163,Cole Burtch (LW),Ferris State University,35,7,19,26,0.74,34,1
164,Isaac Gordon (C),Michigan Tech,36,7,19,26,0.72,8,-4
165,Matt Basgall (D),Michigan State University,37,6,20,26,0.70,8,9
166,Max Burkholder (D),Colorado College,37,6,20,26,0.70,12,-2
167,Joona Väisänen (D),Western Michigan University,42,4,22,26,0.62,12,24
168,Aaron Pionk (D),University of Minnesota-Duluth,36,3,23,26,0.72,12,1
169,Caiden Gault (F),Ferris State University,36,15,10,25,0.69,10,0
170,Brady Risk (RW/LW),University of Nebraska-Omaha,36,13,12,25,0.69,30,6
171,Daniel Russell (C),Michigan State University,37,13,12,25,0.68,27,17
172,Tyler Borgula (RW),Quinnipiac University,38,12,13,25,0.66,20,10
173,Brian Nicholas (F),Brown University,28,11,14,25,0.89,10,-4
174,Ryan Johnson (C),University of Alaska-Anchorage,33,11,14,25,0.76,6,-13
175,Matt Kursonis (C/LW),College of the Holy Cross,27,10,15,25,0.93,14,1
176,Harrison Israels (C),University of Nebraska-Omaha,34,10,15,25,0.74,14,12
177,Jacob Ivey (F),Army (U.S. Military Academy),38,10,15,25,0.66,6,4
178,Tyson Gross (RW),St. Cloud State University,36,9,16,25,0.69,37,-5
179,Michael Abgrall (C),College of the Holy Cross,40,8,17,25,0.63,56,2
180,Jack Hughes (C),Boston University,40,7,18,25,0.63,22,9
181,Stevie Castagna (F),Bentley University,40,5,20,25,0.63,19,7
182,Walter Zacher (C),Robert Morris University,35,15,9,24,0.69,21,3
183,Joshua Barnes (C),American International College,38,14,10,24,0.63,6,-14
184,Christopher Pelosi (C/LW),Quinnipiac University,38,13,11,24,0.63,10,12
185,Cooper Flinton (LW/RW),Dartmouth College,32,11,13,24,0.75,8,5
186,Kirklan Irey (F),Bemidji State University,38,11,13,24,0.63,14,-4
187,Joey Larson (RW/LW),Michigan State University,37,10,14,24,0.65,22,7
188,Sullivan Mack (C/LW),Cornell University,32,9,15,24,0.75,19,13
189,Nolan Renwick (RW/LW),University of Maine,38,9,15,24,0.63,22,25
190,Ty Jackson (C),Arizona State University,35,8,16,24,0.69,18,2
191,Will Gilson (D),RPI (Rensselaer Polytech. Inst.),35,8,16,24,0.69,26,6
192,Tim Rego (D),Cornell University,36,8,16,24,0.67,18,15
193,Logan Will (F),Providence College,37,8,16,24,0.65,4,10
194,Francesco Dell'Elce (D),UMass,40,7,17,24,0.60,12,18
195,Max Nagel (F),Colgate University,36,6,18,24,0.67,12,-4
196,Luigi Benincasa (F),Minnesota State University (Mankato),39,6,18,24,0.62,8,9
197,Matt Copponi (C),Boston University,40,6,18,24,0.60,14,15
198,Michael Craig (D),Robert Morris University,35,5,19,24,0.69,6,-3
199,Tommy Bergsland (D),Colgate University,36,4,20,24,0.67,10,9
200,Abram Wiebe (D),University of North Dakota,38,4,20,24,0.63,24,-2
201,Tom Willander (D),Boston University,39,2,22,24,0.62,8,19
202,Josh Nixon (RW),Union College,36,14,9,23,0.64,20,8
203,Matt Hubbarde (C),University of Alaska-Fairbanks,30,13,10,23,0.77,25,5
204,Colin Kessler (F),University of Vermont,34,12,11,23,0.68,39,-4
205,Elias Jansson (F),Michigan Tech,36,12,11,23,0.64,4,0
206,Brodie Ziemer (RW/LW),University of Minnesota,38,12,11,23,0.61,21,6
207,Hudson Malinoski (C),Providence College,35,11,12,23,0.66,26,-7
208,Kyle Haskins (C),Canisius College,37,11,12,23,0.62,24,-12
209,Tanner Klimpke (F),Robert Morris University,26,10,13,23,0.88,6,12
210,Hunter Bischoff (F),Augustana University,35,10,13,23,0.66,14,3
211,Eric Martin (F),Bemidji State University,37,10,13,23,0.62,8,-6
212,Connor Milburn (F),Lake Superior State University,28,9,14,23,0.82,14,-10
213,Liam Devlin (F),University of New Hampshire,35,9,14,23,0.66,40,-6
214,Dimitry Kebreau (F),University of Alaska-Anchorage,31,8,15,23,0.74,15,-5
215,Tristan Sarsland (D),Clarkson University,39,8,15,23,0.59,16,14
216,Matteo Costantini (C/LW),Western Michigan University,40,8,15,23,0.58,20,10
217,Christian Catalano (RW),RIT (Rochester Inst. of Tech.),33,7,16,23,0.70,73,-10
218,Brett Meerman (F),Augustana University,35,7,16,23,0.66,2,0
219,Reilly Funk (C),Bemidji State University,36,7,16,23,0.64,21,1
220,Joe Miller (C),Harvard University,28,5,18,23,0.82,8,5
221,Brody Waters (LW),Bowling Green State University,36,16,6,22,0.61,20,5
222,Jackson Jutting (F),Bemidji State University,38,14,8,22,0.58,4,-12
223,Dylan James (LW),University of North Dakota,38,14,8,22,0.58,20,-4
224,Anthony Galante (F),Stonehill College,31,13,9,22,0.71,37,-4
225,Cullen Potter (C/LW),Arizona State University,35,13,9,22,0.63,6,-1
226,Cameron Berg (C/LW),University of North Dakota,26,12,10,22,0.85,16,-2
227,Zach Urdahl (LW/RW),University of Nebraska-Omaha,33,12,10,22,0.67,6,4
228,Max Dorrington (RW/LW),Sacred Heart University,38,12,10,22,0.58,47,4
229,Evan Werner (F),University of Michigan,33,11,11,22,0.67,21,-12
230,Matthew Gleason (C),University of St. Thomas,35,11,11,22,0.63,43,10
231,Nik Hong (F),Army (U.S. Military Academy),36,11,11,22,0.61,10,-9
232,Tanner Adams (RW/C),Providence College,37,11,11,22,0.59,8,0
233,Hayden Stavroff (F),Dartmouth College,31,10,12,22,0.71,43,3
234,Timo Bakos (F),Lake Superior State University,34,10,12,22,0.65,6,-9
235,Ben Doran (F),Bowling Green State University,36,10,12,22,0.61,43,9
236,Ondrej Psenicka (RW),Cornell University,30,9,13,22,0.73,10,9
237,Max Strand (F),University of Vermont,33,8,14,22,0.67,8,1
238,Joseph Dunlap (RW/C),Ohio State University,39,8,14,22,0.56,22,3
239,Michael Felsing (F),Robert Morris University,34,7,15,22,0.65,2,-12
240,Cameron Garvey (C),Robert Morris University,34,7,15,22,0.65,6,12
241,Barrett Hall (C),St. Cloud State University,34,7,15,22,0.65,6,-10
242,Nils Forselius (F),Army (U.S. Military Academy),35,7,15,22,0.63,18,5
243,Chase Pietila (D),Michigan Tech,36,7,15,22,0.61,52,1
244,Tyler Hotson (F),RPI (Rensselaer Polytech. Inst.),35,6,16,22,0.63,47,3
245,Vincent Borgesi (D),Northeastern University,32,5,17,22,0.69,16,1
246,Jimmy Clark (LW/C),University of Minnesota,39,5,17,22,0.56,0,15
247,Chase Foley (D),University of St. Thomas,37,3,19,22,0.59,18,13
248,Austin Schwartz (F),Air Force Academy,40,12,9,21,0.53,6,-3
249,Logan Morrell (RW/LW),Michigan Tech,32,11,10,21,0.66,29,5
250,John Fusco (D),Dartmouth College,32,11,10,21,0.66,39,15
251,James Reeder (RW),University of Denver,44,11,10,21,0.48,2,17
252,Mickey Burns (LW),Mercyhurst University,32,10,11,21,0.66,23,-6
253,Austin Brimmer (RW),Long Island University,32,9,12,21,0.66,15,9
254,Simon Jellus (C/LW),University of Vermont,35,9,12,21,0.60,14,-2
255,Broten Sabo (D),University of Alaska-Fairbanks,32,8,13,21,0.66,31,-4
256,Payton Matsui (F),Augustana University,34,8,13,21,0.62,2,17
257,Steven Agriogianis (RW),Mercyhurst University,34,8,13,21,0.62,8,-22
258,Verner Miettinen (C),St. Cloud State University,36,8,13,21,0.58,10,-5
259,Zaccharya Wisdom (RW),Colorado College,36,8,13,21,0.58,12,3
260,Benjamin Ivey (F),Army (U.S. Military Academy),37,8,13,21,0.57,10,5
261,Tabor Heaslip (F),University of Connecticut,39,8,13,21,0.54,22,3
262,Dustin Geregach (D),Mercyhurst University,35,7,14,21,0.60,10,-15
263,Bret Link (RW/LW),Colorado College,37,7,14,21,0.57,24,5
264,Kaleb Ergang (RW),Ferris State University,35,6,15,21,0.60,6,3
265,Félix Caron (RW),RPI (Rensselaer Polytech. Inst.),35,6,15,21,0.60,62,-10
266,Axel Kumlin (D),University of Notre Dame,38,6,15,21,0.55,12,-5
267,Ryan O'Neill (F),University of St. Thomas,38,6,15,21,0.55,20,-9
268,Hunter Sansbury (D),Sacred Heart University,39,6,15,21,0.54,30,12
269,Ryan Lautenbach (RW/LW),UMass,40,6,15,21,0.53,19,5
270,Hank Cleaves (F),Dartmouth College,32,5,16,21,0.66,10,5
271,Seamus Powell (D),Merrimack College,35,5,16,21,0.60,2,-8
272,Ethan Edwards (D),University of Michigan,36,5,16,21,0.58,40,-2
273,Marcus Joughin (F),Sacred Heart University,39,3,18,21,0.54,14,-2
274,Paul Fischer (D),University of Notre Dame,36,2,19,21,0.58,16,-19
275,Luke Mobley (F),Augustana University,34,13,7,20,0.59,14,6
276,Jakob Lee (C),RPI (Rensselaer Polytech. Inst.),35,13,7,20,0.57,26,6
277,Dane Dowiak (C/LW),Penn State University,40,12,8,20,0.50,20,4
278,Ronan O'Donnell (RW),Yale University,29,11,9,20,0.69,31,-10
279,Dario Beljo (C),American International College,30,11,9,20,0.67,10,-2
280,Garrett Schifsky (C),University of Michigan,36,11,9,20,0.56,14,0
281,Dovar Tinling (C),RPI (Rensselaer Polytech. Inst.),32,10,10,20,0.63,18,-1
282,Graham Gamache (F),Providence College,37,10,10,20,0.54,10,4
283,John Lundy (F),American International College,37,10,10,20,0.54,10,-12
284,Owen Fowler (LW),University of Maine,38,10,10,20,0.53,16,5
285,Brian Carrabes (F),Minnesota State University (Mankato),39,10,10,20,0.51,8,12
286,Nick Ring (F),University of New Hampshire,35,9,11,20,0.57,4,-14
287,Jagger Tapper (F),RPI (Rensselaer Polytech. Inst.),29,8,12,20,0.69,8,9
288,Cam Mitchell (LW),University of Nebraska-Omaha,33,8,12,20,0.61,10,7
289,Michael Neumeier (D),Colgate University,35,8,12,20,0.57,9,10
290,Owen Cole (C),UMass-Lowell,36,8,12,20,0.56,6,1
291,Ryan Chesley (D),University of Minnesota,40,8,12,20,0.50,48,17
292,Zam Plante (C),University of Minnesota-Duluth,33,7,13,20,0.61,0,1
293,Colby Ambrosio (C/RW),Miami University (Ohio),34,7,13,20,0.59,45,-32
294,Jacob Guévin (D),University of Nebraska-Omaha,36,7,13,20,0.56,10,4
295,John Mustard (LW),Providence College,37,7,13,20,0.54,14,1
296,Ben Schoen (C),Penn State University,37,7,13,20,0.54,27,-9
297,Kyle Gaffney (F),University of Alaska-Fairbanks,32,6,14,20,0.63,6,-6
298,Rieger Lorenz (LW/C),University of Denver,44,6,14,20,0.45,18,14
299,John Waldron (F),Miami University (Ohio),28,4,16,20,0.71,8,-19
300,Eamon Powell (D),Boston College,32,4,16,20,0.63,12,20
301,Brandon Holt (D),University of Maine,34,4,16,20,0.59,12,9
302,Lucas Ölvestad (D),UMass,38,4,16,20,0.53,22,8
303,Mike Koster (D),University of Minnesota,40,4,16,20,0.50,14,9
304,Sasha Teleguine (F),Lake Superior State University,32,14,5,19,0.59,34,-4
305,Josh Zary (F),Long Island University,29,12,7,19,0.66,14,-1
306,Anthony Menghini (F),University of Minnesota-Duluth,35,12,7,19,0.54,15,6
307,Timothy Heinke (RW),College of the Holy Cross,39,12,7,19,0.49,24,1
308,Gregory Lapointe (F),St. Lawrence University,34,11,8,19,0.56,18,-15
309,Jayden Perron (RW),University of North Dakota,31,10,9,19,0.61,7,-2
310,Grayden Slipec (F),Northern Michigan University,32,10,9,19,0.59,14,-15
311,Gavin Best (F),Ferris State University,36,10,9,19,0.53,4,-3
312,Kyle Kukkonen (C/RW),University of Wisconsin,37,10,9,19,0.51,22,-1
313,Klavs Veinbergs (C/LW),Colorado College,36,9,10,19,0.53,32,-8
314,Jake Braccini (RW),University of St. Thomas,37,9,10,19,0.51,16,3
315,Jake Percival (F),University of Connecticut,39,9,10,19,0.49,14,5
316,Tyler Ghirardosi (F),Sacred Heart University,32,8,11,19,0.59,12,4
317,Max Helgeson (F),University of Alaska-Anchorage,34,8,11,19,0.56,16,-7
318,Ryan Bottrill (F),Clarkson University,39,8,11,19,0.49,26,5
319,Jack Seymour (RW),College of the Holy Cross,34,7,12,19,0.56,34,7
320,Brent Keefer (F),Army (U.S. Military Academy),36,7,12,19,0.53,29,-5
321,Jere Väisänen (F),Bemidji State University,38,7,12,19,0.50,16,-7
322,Brennan Ali (C/LW),University of Notre Dame,38,7,12,19,0.50,18,-1
323,Matthew Guerra (F),Sacred Heart University,39,7,12,19,0.49,37,8
324,John Beaton (C),RPI (Rensselaer Polytech. Inst.),34,6,13,19,0.56,0,-10
325,Dominic Elliott (D),Robert Morris University,35,6,13,19,0.54,18,-6
326,Mirko Buttazzoni (F),UMass-Lowell,32,5,14,19,0.59,16,-3
327,Aaron Huglen (W/C),University of Minnesota,38,5,14,19,0.50,10,4
328,Jakub Altrichter (C),Northern Michigan University,32,3,16,19,0.59,4,-7
329,Maxim Strbak (D),Michigan State University,33,3,16,19,0.58,16,6
330,Kamil Bednarik (C),Boston University,40,2,17,19,0.48,28,1
331,Luke Haymes (C/LW),Dartmouth College,22,12,6,18,0.82,14,-1
332,Timofei Spitserov (RW),University of Vermont,33,12,6,18,0.55,4,4
333,William Whitelaw (C),University of Michigan,35,11,7,18,0.51,30,7
334,Noah Hackett (F),Niagara University,36,11,7,18,0.50,10,-1
335,Thomas Freel (C),University of Maine,38,11,7,18,0.47,20,9
336,Drew Montgomery (F),Colorado College,34,10,8,18,0.53,18,9
337,Scout Truman (LW),UMass-Lowell,36,10,8,18,0.50,52,-3
338,Devin Kaplan (RW),Boston University,38,10,8,18,0.47,65,-8
339,Talon Sigurdson (F),Clarkson University,39,10,8,18,0.46,21,11
340,Tyler Schleppe (F),Ferris State University,29,9,9,18,0.62,8,-2
341,A.J. Hodges (LW),Bentley University,30,9,9,18,0.60,8,7
342,Chris Delaney (C),UMass-Lowell,35,9,9,18,0.51,16,-12
343,Ben Raymond (C/LW),Colgate University,36,9,9,18,0.50,21,-2
344,Carter Wilkie (RW),University of North Dakota,38,9,9,18,0.47,42,0
345,Brendan Gibbons (C),Air Force Academy,39,9,9,18,0.46,15,-14
346,Ryan Mansfield (LW),Bentley University,31,8,10,18,0.58,4,7
347,Timofei Khokhlachev (LW),American International College,32,8,10,18,0.56,50,5
348,Massimo-Sarantos Lombardi (C),University of Vermont,35,8,10,18,0.51,8,-15
349,Will Elger (F),Providence College,36,8,10,18,0.50,4,5
350,Ethan Gardula (LW),University of Connecticut,37,8,10,18,0.49,19,-2
351,Will Dineen (LW/RW),Yale University,30,6,12,18,0.60,24,-1
352,Henri Schreifels (F),Stonehill College,33,6,12,18,0.55,25,-3
353,Brett Bamber (D),American International College,35,6,12,18,0.51,14,-19
354,Travis Shoudy (D),Ferris State University,36,6,12,18,0.50,8,1
355,Charlie Major (F),Cornell University,28,5,13,18,0.64,6,7
356,Brett Pfoh (F),Bowling Green State University,32,5,13,18,0.56,16,6
357,Trent Wilson (F),Robert Morris University,35,5,13,18,0.51,18,-4
358,Cristophe Tellier (LW/C),Northeastern University,36,5,13,18,0.50,36,-12
359,Adam Flammang (RW),Bemidji State University,38,5,13,18,0.47,27,-7
360,Nolan Cunningham (D),Air Force Academy,40,5,13,18,0.45,26,-15
361,Chris Pappas (C),Long Island University,21,4,14,18,0.86,8,3
362,J.R. Perdion (F),Long Island University,31,4,14,18,0.58,10,8
363,John Herrington (C),Lake Superior State University,36,4,14,18,0.50,18,-8
364,Erik Påhlsson (C/W),University of Minnesota,30,3,15,18,0.60,6,7
365,Nate Schweitzer (D),Lake Superior State University,34,3,15,18,0.53,42,-9
366,Elliott McDermott (D),RPI (Rensselaer Polytech. Inst.),35,3,15,18,0.51,4,0
367,Isa Parekh (D),Bemidji State University,35,3,15,18,0.51,18,-5
368,Rylan Brown (D),Michigan Tech,36,3,15,18,0.50,14,-2
369,Nicklas Andrews (D),Michigan State University,37,2,16,18,0.49,14,28
370,Mac Swanson (LW/C),University of North Dakota,38,2,16,18,0.47,2,0
371,Luke Mittelstadt (D),University of Minnesota,40,2,16,18,0.45,8,23
372,Sebastian Törnqvist (D),University of Vermont,31,1,17,18,0.58,46,-9
373,Kaden Bohlsen (C),Minnesota State University (Mankato),28,12,5,17,0.61,31,13
374,Mitchel Deelstra (LW/C),Robert Morris University,35,12,5,17,0.49,34,-15
375,Chase Dafoe (F),University of Alaska-Fairbanks,32,11,6,17,0.53,39,-2
376,David Chen (F),Yale University,18,10,7,17,0.94,23,-4
377,Gleb Veremyev (C/LW),Colorado College,37,9,8,17,0.46,50,5
378,Jared Wright (RW),University of Denver,44,9,8,17,0.39,6,17
379,Tyler Cristall (F),St. Lawrence University,29,8,9,17,0.59,12,-8
380,Jake Manfre (F),Princeton University,30,8,9,17,0.57,12,-1
381,Alec Cicero (F),Canisius College,34,8,9,17,0.50,33,-7
382,Jack O'Leary (F),Cornell University,35,8,9,17,0.49,19,5
383,Martins Lavins (C),University of New Hampshire,35,8,9,17,0.49,34,-2
384,Jackson Hallum (F),University of Michigan,36,8,9,17,0.47,18,-3
385,Tanner Kelly (F),Michigan State University,37,8,9,17,0.46,20,10
386,Trey Funk (F),Canisius College,37,8,9,17,0.46,23,-19
387,Tiernan Shoudy (F),Michigan State University,37,8,9,17,0.46,24,11
388,Onni Leppänen (C/W),Long Island University,21,7,10,17,0.81,2,-1
389,Isaac Lambert (C),Long Island University,31,7,10,17,0.55,15,1
390,Colton Friesen (F),Augustana University,32,7,10,17,0.53,6,2
391,Dawson Tritt (F),Lake Superior State University,33,7,10,17,0.52,33,-11
392,Caden Cranston (F),Merrimack College,35,7,10,17,0.49,2,-13
393,John Gelatt (F),College of the Holy Cross,37,7,10,17,0.46,10,10
394,Joe Connor (C/LW),Northeastern University,37,7,10,17,0.46,47,-10
395,Daniel Alexander Jencko (C/LW),UMass,28,6,11,17,0.61,10,9
396,Reid Irwin (D/C),Colgate University,32,6,11,17,0.53,8,0
397,Isak Walther (RW),University of Vermont,33,6,11,17,0.52,10,-2
398,Jack Brackett (F),RPI (Rensselaer Polytech. Inst.),35,6,11,17,0.49,10,4
399,Christian Fitzgerald (F),University of Wisconsin,37,6,11,17,0.46,24,-11
400,Conor Cole (C),University of Alaska-Anchorage,28,4,13,17,0.61,12,-10
401,Alex Gagne (D),University of New Hampshire,35,4,13,17,0.49,46,0
402,Zach Bookman (D),Merrimack College,33,3,14,17,0.52,22,-5
403,William Zapernick (C/RW),University of Vermont,35,3,14,17,0.49,10,-11
404,Trey Scott (D),University of Connecticut,36,3,14,17,0.47,8,4
405,Ben Meehan (D),UMass-Lowell,36,3,14,17,0.47,29,-4
406,Alex Murray (D),Niagara University,37,3,14,17,0.46,28,-2
407,Dalton Norris (D),Bowling Green State University,36,2,15,17,0.47,17,0
408,Brian Kramer (D),Western Michigan University,42,2,15,17,0.40,16,28
409,Ben Dexheimer (D),University of Wisconsin,35,1,16,17,0.49,2,-16
410,Davis Pennington (D),Quinnipiac University,38,1,16,17,0.45,20,7
411,Oskar Kind Bakkevig (RW),Bentley University,28,10,6,16,0.57,29,3
412,Isaiah Fox (F),Long Island University,31,9,7,16,0.52,54,0
413,Dillan Bentley (F),UMass-Lowell,34,9,7,16,0.47,16,-5
414,Branden Piku (F),Lake Superior State University,34,9,7,16,0.47,24,-4
415,Patrick Guzzo (C),Ohio State University,36,9,7,16,0.44,8,8
416,Nick Poisson (F),Providence College,37,8,8,16,0.43,16,3
417,Ben Strinden (C),University of North Dakota,38,8,8,16,0.42,14,5
418,Hunter Strand (C),University of Notre Dame,38,8,8,16,0.42,20,-7
419,Samuel Stitz (F),Air Force Academy,39,8,8,16,0.41,8,2
420,Kellan Hjartarson (F),Bentley University,40,8,8,16,0.40,4,0
421,Dylan Jackson (RW),Arizona State University,25,7,9,16,0.64,10,2
422,Braiden Dorfman (F),Dartmouth College,31,7,9,16,0.52,22,9
423,Alex Pineau (D),Brown University,32,7,9,16,0.50,14,-3
424,Tanner Andrew (C),RIT (Rochester Inst. of Tech.),34,7,9,16,0.47,33,-14
425,Ethan Scardina (C),Bowling Green State University,35,7,9,16,0.46,31,-1
426,Luka Sukovic (F),Clarkson University,36,7,9,16,0.44,16,7
427,Kasper Magnussen (LW),Bemidji State University,37,7,9,16,0.43,44,-13
428,Joey Baez (F),Army (U.S. Military Academy),38,7,9,16,0.42,14,-19
429,Victor Czerneckianair (C),Quinnipiac University,38,7,9,16,0.42,21,23
430,Nace Langus (C),Augustana University,29,6,10,16,0.55,8,8
431,Cameron MacDonald (F),Dartmouth College,33,6,10,16,0.48,10,1
432,Matt Choupani (C),Miami University (Ohio),34,6,10,16,0.47,28,-18
433,Ville Immonen (C),Bowling Green State University,36,6,10,16,0.44,4,-1
434,Logan Sawyer (LW),Providence College,37,6,10,16,0.43,10,7
435,Shane Vansaghi (RW),Michigan State University,37,6,10,16,0.43,30,10
436,David Gucciardi (D),Michigan State University,37,6,10,16,0.43,42,21
437,Jake Schmaltz (LW/C),University of North Dakota,38,6,10,16,0.42,26,2
438,Ben MacDonald (C),Harvard University,27,5,11,16,0.59,18,5
439,Simon Falk (RW),Augustana University,32,5,11,16,0.50,2,13
440,Nick Pierre (F),Merrimack College,34,5,11,16,0.47,8,-8
441,Jak Vaarwerk (C),UMass-Lowell,36,5,11,16,0.44,12,-1
442,Gustav Stjernberg (D),Bowling Green State University,30,4,12,16,0.53,35,7
443,Noah Houle (D),Lindenwood University,32,4,12,16,0.50,26,7
444,Mason Waite (D),St. Lawrence University,35,4,12,16,0.46,6,-15
445,Cullen Ferguson (D),Union College,36,4,12,16,0.44,39,-6
446,Noah Serdachny (F),American International College,37,4,12,16,0.43,10,-10
447,Tate Taylor (D),Clarkson University,33,3,13,16,0.48,10,5
448,Jacob Truscott (D),University of Michigan,36,3,13,16,0.44,27,-3
449,Sully Scholle (F),University of Maine,38,3,13,16,0.42,8,-5
450,Gavin McCarthy (D),Boston University,39,3,13,16,0.41,51,3
451,Grant Porter (F),Canisius College,33,10,5,15,0.45,12,-7
452,Oliver Tarr (RW),Canisius College,30,8,7,15,0.50,8,-6
453,Jake Gagnon (RW),RPI (Rensselaer Polytech. Inst.),33,8,7,15,0.45,12,-6
454,Evan Orr (D),Stonehill College,34,8,7,15,0.44,18,-12
455,Arlo Merritt (C),Bentley University,35,8,7,15,0.43,10,10
456,Jimmy Glynn (F),University of Nebraska-Omaha,35,8,7,15,0.43,14,-2
457,Samuel Duerr (D),Bentley University,37,8,7,15,0.41,12,8
458,Jake Fisher (C/LW),University of Denver,42,8,7,15,0.36,12,8
459,Anthony Lucarelli (C),Long Island University,29,7,8,15,0.52,8,9
460,Jaxson Ezman (F),Princeton University,30,7,8,15,0.50,28,-2
461,Alton McDermott (RW),Canisius College,33,7,8,15,0.45,6,5
462,Joey DelGreco (F),Augustana University,35,7,8,15,0.43,20,3
463,Jackson Kunz (LW),University of North Dakota,36,7,8,15,0.42,21,7
464,Artem Buzoberya (LW),Bentley University,32,6,9,15,0.47,4,5
465,Felikss Gavars (F),St. Lawrence University,34,6,9,15,0.44,25,-18
466,Caelan Fitzpatrick (C/LW),Merrimack College,35,6,9,15,0.43,16,0
467,Ty Daneault (RW),Merrimack College,35,6,9,15,0.43,40,-7
468,Kieran Cebrian (F),University of Denver,44,6,9,15,0.34,16,12
469,Micah Berger (LW),Yale University,21,5,10,15,0.71,6,-9
470,Ryan Sullivan (F),Colgate University,23,5,10,15,0.65,20,1
471,Xavier Lapointe (D),RIT (Rochester Inst. of Tech.),27,5,10,15,0.56,45,-5
472,Jack Works (F),Michigan Tech,31,5,10,15,0.48,20,2
473,Jonathan Castagna (C),Cornell University,32,5,10,15,0.47,20,2
474,Nicholas Rexine (C),Colgate University,33,5,10,15,0.45,12,6
475,Max Smolinski (D),RPI (Rensselaer Polytech. Inst.),35,5,10,15,0.43,6,-3
476,Ryan Coughlin (F),Mercyhurst University,35,5,10,15,0.43,12,-14
477,Cam Knuble (F),Western Michigan University,41,5,10,15,0.37,4,15
478,Philippe Blais-Savoie (D),Colorado College,30,4,11,15,0.50,10,4
479,Michael Mastrodomenico (D),University of Notre Dame,30,4,11,15,0.50,18,-4
480,Nicholas Remissong (F),Air Force Academy,36,4,11,15,0.42,14,-9
481,Jake Schneider (RW),Colgate University,36,4,11,15,0.42,14,10
482,Owen Gallatin (D),University of Minnesota-Duluth,36,4,11,15,0.42,15,-8
483,Justin Mexico (F),American International College,32,3,12,15,0.47,12,-3
484,Hayden Hennen (D),Augustana University,34,3,12,15,0.44,29,9
485,Tyler Rollwagen (F),University of Nebraska-Omaha,36,3,12,15,0.42,26,-15
486,Tristan Allen (D),RIT (Rochester Inst. of Tech.),33,2,13,15,0.45,45,-22
487,Jax Wismer (D),University of Vermont,34,2,13,15,0.44,22,-1
488,Lukas Gustafsson (D),Boston College,35,2,13,15,0.43,14,16
489,Aram Minnetian (D),Boston College,35,2,13,15,0.43,16,20
490,Ben Robertson (D),Cornell University,36,2,13,15,0.42,8,11
491,Jackson Dorrington (D),Northeastern University,37,2,13,15,0.41,20,-2
492,Cade Mason (D),Long Island University,29,1,14,15,0.52,6,-1
493,Lars Christian Rødne (LW),Niagara University,29,10,4,14,0.48,6,2
494,Kaden Shahan (RW),University of Connecticut,39,9,5,14,0.36,4,-4
495,Nick DeSantis (F),Cornell University,33,8,6,14,0.42,24,11
496,Lee Parks (RW),UMass-Lowell,34,8,6,14,0.41,10,6
497,Antonio Venuto (RW),Merrimack College,35,8,6,14,0.40,8,-12
498,Riley Fitzgerald (F),Mercyhurst University,33,7,7,14,0.42,6,-17
499,Simon Isabelle (RW),RIT (Rochester Inst. of Tech.),35,7,7,14,0.40,12,-2
500,Vincent Salice (C),Army (U.S. Military Academy),35,6,8,14,0.40,6,0
501,Quinn Emerson (RW/C),Bowling Green State University,35,6,8,14,0.40,10,6
502,Samuel Deckhut (C),Ohio State University,37,6,8,14,0.38,10,7
503,Dominic Payne (D),Canisius College,37,6,8,14,0.38,14,2
504,Garrett Dahm (F),Clarkson University,38,6,8,14,0.37,12,0
505,Caige Sterzer (F),University of St. Thomas,38,6,8,14,0.37,33,1
506,Zach Krajnik (C),Minnesota State University (Mankato),39,6,8,14,0.36,6,9
507,Tristan Lemyre (C),Western Michigan University,42,6,8,14,0.33,16,2
508,Matt Crasa (C/RW),UMass-Lowell,29,5,9,14,0.48,12,1
509,Antonio Fernandez (D),Colgate University,31,5,9,14,0.45,10,-5
510,Daimon Gardner (C),St. Cloud State University,32,5,9,14,0.44,14,0
511,Luke Levandowski (F),Lake Superior State University,34,5,9,14,0.41,4,-2
512,Boris Skalos (F),Mercyhurst University,34,5,9,14,0.41,12,-19
513,Kyler Kovich (LW),Cornell University,36,5,9,14,0.39,25,13
514,Owen Murray (D),UMass,40,5,9,14,0.35,16,5
515,Robby Drazner (D),Western Michigan University,42,5,9,14,0.33,6,18
516,Nick Marciano (D),Princeton University,30,4,10,14,0.47,4,-5
517,Raimonds Vitolins (C),Miami University (Ohio),31,4,10,14,0.45,12,-13
518,Ty Hanson (D),University of Minnesota-Duluth,36,4,10,14,0.39,14,-8
519,Aiden Dubinsky (D),University of Minnesota-Duluth,36,4,10,14,0.39,20,-2
520,David Jacobs (RW),Princeton University,26,3,11,14,0.54,0,-3
521,Zachary Wagnon (F),Yale University,30,3,11,14,0.47,18,-6
522,Brendan Ross (F),University of Alaska-Fairbanks,31,3,11,14,0.45,10,-11
523,Aaron Bohlinger (D),Quinnipiac University,32,3,11,14,0.44,4,11
524,Ian Moore (D),Harvard University,32,3,11,14,0.44,14,-5
525,Parker Lindauer (F),Union College,34,3,11,14,0.41,10,-3
526,Ross Roloson (D),Niagara University,37,3,11,14,0.38,6,4
527,Morgan Winters (F),University of New Hampshire,26,2,12,14,0.54,8,4
528,Luke van Why (D),Robert Morris University,31,2,12,14,0.45,12,-3
529,Andrew Centrella (D),Providence College,34,2,12,14,0.41,8,-6
530,Nick Anderson (D),UMass-Lowell,35,2,12,14,0.40,14,-1
531,Dylan Gratton (D),University of Nebraska-Omaha,36,2,12,14,0.39,6,-2
532,Guillaume Richard (D),Providence College,37,2,12,14,0.38,14,7
533,Taige Harding (D),Providence College,37,2,12,14,0.38,46,9
534,Tomas Mazura (C),St. Lawrence University,17,1,13,14,0.82,4,-7
535,George Fegaras (D),Cornell University,30,1,13,14,0.47,10,1
536,Austen May (D),Providence College,34,1,13,14,0.41,6,7
537,Cooper Moore (D),Quinnipiac University,37,1,13,14,0.38,16,10
538,Chase Cheslock (D),University of St. Thomas,38,1,13,14,0.37,22,16
539,Evan Bushy (D),Lake Superior State University,33,0,14,14,0.42,8,-8
540,Kai Janviriya (D),University of Connecticut,39,0,14,14,0.36,6,5
541,Daniel Panetta (C),Colgate University,25,10,3,13,0.52,12,10
542,Zach Faremouth (F),Ferris State University,33,8,5,13,0.39,17,-7
543,Will Vote (RW),Boston College,37,8,5,13,0.35,12,6
544,Ty Henricks (LW),Western Michigan University,41,8,5,13,0.32,8,16
545,Lynden Breen (C/LW),University of Maine,22,7,6,13,0.59,18,5
546,Luc Wilson (F),Minnesota State University (Mankato),32,7,6,13,0.41,24,0
547,Jacob Kraft (C),Cornell University,36,7,6,13,0.36,4,5
548,Gavin O'Connell (RW),Michigan State University,28,6,7,13,0.46,10,5
549,Tyler Hennen (F),Augustana University,28,6,7,13,0.46,21,11
550,David Ma (D),Princeton University,30,6,7,13,0.43,33,0
551,Cole Galata (F),Sacred Heart University,38,6,7,13,0.34,11,4
552,Erik Bargholtz (F),Clarkson University,39,6,7,13,0.33,12,-2
553,Lucas Buzziol (C),Union College,29,5,8,13,0.45,14,-3
554,Tyler Duke (D),University of Michigan,29,5,8,13,0.45,33,-2
555,Matt Koethe (F),University of Alaska-Fairbanks,32,5,8,13,0.41,14,-8
556,Blake Steenerson (F),University of Vermont,32,5,8,13,0.41,23,5
557,Jacob Hewitt (F),Sacred Heart University,33,5,8,13,0.39,14,5
558,Jaden Grant (F),Bowling Green State University,34,5,8,13,0.38,20,-1
559,Rainers Rullers (C),RPI (Rensselaer Polytech. Inst.),34,5,8,13,0.38,25,-8
560,J.P. Turner (C),University of New Hampshire,35,5,8,13,0.37,22,0
561,Brent Johnson (D),Ohio State University,38,5,8,13,0.34,4,-6
562,Luke Ashton (D),Minnesota State University (Mankato),38,5,8,13,0.34,6,10
563,Ryan Gordon (C),Ohio State University,39,5,8,13,0.33,27,-1
564,Oskar Jellvik (LW/C),Boston College,23,4,9,13,0.57,10,6
565,Trevor Connelly (LW),Providence College,23,4,9,13,0.57,29,-13
566,Ryan Healey (D),Harvard University,33,4,9,13,0.39,12,-4
567,Ty Gagno (F),College of the Holy Cross,33,4,9,13,0.39,26,1
568,James Hong (F),Ohio State University,34,4,9,13,0.38,17,2
569,Dominick Campione (D),Stonehill College,31,3,10,13,0.42,30,-8
570,Easton Young (D),Augustana University,33,3,10,13,0.39,25,7
571,Brett Rylance (C/W),American International College,35,3,10,13,0.37,12,-1
572,Tyson Dyck (C),University of Wisconsin,37,3,10,13,0.35,10,3
573,David Breazeale (D),University of Maine,38,3,10,13,0.34,10,15
574,Sascha Boumedienne (D),Boston University,40,3,10,13,0.33,33,8
575,Peyton Platter (C/LW/RW),University of Alaska-Fairbanks,32,2,11,13,0.41,24,-6
576,Trenton Powell (D),Long Island University,34,2,11,13,0.38,8,9
577,Griffin Ludtke (D),University of Nebraska-Omaha,36,2,11,13,0.36,21,0
578,Hoyt Stanley (D),Cornell University,36,2,11,13,0.36,40,14
579,Anthony Dowd (D),Arizona State University,37,2,11,13,0.35,10,13
580,Simon Labelle (LW),Colgate University,25,1,12,13,0.52,8,1
581,Ryan Upson (F),Bentley University,33,1,12,13,0.39,6,14
582,Jackson Decker (D),Canisius College,34,1,12,13,0.38,16,-7
583,John Spetz (D),University of Connecticut,35,1,12,13,0.37,27,14
584,Dylan Contreras (F),University of Alaska-Anchorage,29,8,4,12,0.41,6,-6
585,Reagan Milburn (F),Lake Superior State University,24,7,5,12,0.50,18,-5
586,Donovan Frias (LW),Yale University,30,7,5,12,0.40,20,-11
587,Spencer Young (C),Niagara University,34,7,5,12,0.35,19,5
588,Adam Marshall (LW),Army (U.S. Military Academy),38,7,5,12,0.32,33,-3
589,Teddy Lagerback (LW),Stonehill College,19,6,6,12,0.63,4,6
590,Owen Bohn (F),Augustana University,23,6,6,12,0.52,8,1
591,Will Margel (W/C),Mercyhurst University,24,6,6,12,0.50,16,-17
592,Myles Hilman (F),University of Nebraska-Omaha,25,6,6,12,0.48,4,14
593,Libor Nemec (RW/LW),UMass-Lowell,26,6,6,12,0.46,14,-9
594,Dominik Bartecko (F),Mercyhurst University,31,6,6,12,0.39,2,-12
595,Brendan Clark (F),Brown University,31,6,6,12,0.39,30,2
596,Michael Emerson (RW),Merrimack College,32,6,6,12,0.38,0,1
597,Philippe Lapointe (F),University of Michigan,34,6,6,12,0.35,10,3
598,Frank Ireland (F),Stonehill College,34,6,6,12,0.35,26,-10
599,Matthew Campbell (D),Michigan Tech,34,6,6,12,0.35,26,7
600,William Ahlrik (C),Lake Superior State University,35,6,6,12,0.34,24,1
601,Stan Cooley (C),Colorado College,37,6,6,12,0.32,28,-17
602,Jake Southgate (C),Lindenwood University,30,5,7,12,0.40,10,-1
603,Luca Münzenberger (D),University of Vermont,31,5,7,12,0.39,18,11
604,William Elias (D),College of the Holy Cross,32,5,7,12,0.38,16,4
605,Jake Rozzi (LW),Ohio State University,33,5,7,12,0.36,2,-2
606,Justin Solovey (F),Harvard University,33,5,7,12,0.36,16,4
607,Danny Weight (C),American International College,34,5,7,12,0.35,37,-8
608,Oscar Geschwind (F),American International College,36,5,7,12,0.33,4,-3
609,John Evans (F),Lindenwood University,28,4,8,12,0.43,6,0
610,Alexander Krause (F),Dartmouth College,31,4,8,12,0.39,0,13
611,Philip Tresca (C),Harvard University,31,4,8,12,0.39,6,1
612,Cole Kodsi (LW),Canisius College,31,4,8,12,0.39,8,-6
613,Isaac Tremblay (C),St. Lawrence University,33,4,8,12,0.36,25,-20
614,Connor Gregga (F),Long Island University,33,4,8,12,0.36,38,-1
615,Dylan Lugris (F),Penn State University,34,4,8,12,0.35,6,-8
616,Brock Bremer (LW),University of Nebraska-Omaha,36,4,8,12,0.33,20,-3
617,Michael Colella (F),Canisius College,37,4,8,12,0.32,6,-10
618,Elliott Groenewold (D),Quinnipiac University,38,4,8,12,0.32,18,5
619,Tristan Fraser (F),University of Connecticut,39,4,8,12,0.31,18,0
620,Cale Ashcroft (D),University of Denver,44,4,8,12,0.27,8,8
621,Joaquim Lemay (D),Northeastern University,30,3,9,12,0.40,29,-11
622,Logan Heroux (D),Ferris State University,32,3,9,12,0.38,28,1
623,Jordan Biro (C),American International College,36,3,9,12,0.33,6,-7
624,Ralfs Bergmanis (D),Minnesota State University (Mankato),36,3,9,12,0.33,29,16
625,Trevor Taulien (D),Ferris State University,36,3,9,12,0.33,33,-10
626,Beckett Hendrickson (C/LW),University of Minnesota,39,3,9,12,0.31,18,-1
627,Cole Crusberg-Roseen (D),Western Michigan University,42,3,9,12,0.29,10,25
628,Ethan Mistry (D),Brown University,32,2,10,12,0.38,6,4
629,Logan Hensler (D),University of Wisconsin,32,2,10,12,0.38,27,-13
630,Michael Quinn (D),Miami University (Ohio),34,2,10,12,0.35,4,-26
631,Isac Jonsson (D),UMass-Lowell,35,2,10,12,0.34,4,-2
632,Mark Estapa (F),University of Michigan,35,2,10,12,0.34,32,-2
633,Jake Boltmann (D),Northeastern University,35,2,10,12,0.34,39,-2
634,Valtteri Piironen (D),Long Island University,34,1,11,12,0.35,8,8
635,Luke Reid (D),University of New Hampshire,35,1,11,12,0.34,10,-7
636,Anthony Kehrer (D),University of Wisconsin,35,1,11,12,0.34,14,13
637,Jaeden Mercier (F),Lindenwood University,30,8,3,11,0.37,4,-2
638,Cody Laskosky (C),University of Wisconsin,27,7,4,11,0.41,4,6
639,Alfred Lindberg (C),American International College,33,7,4,11,0.33,4,-17
640,Riley Wallack (F),Long Island University,14,6,5,11,0.79,8,4
641,Simon Tassy (F),University of Wisconsin,31,6,5,11,0.35,10,-11
642,Jared Mangan (C),Clarkson University,38,6,5,11,0.29,10,0
643,Ethan Whitcomb (RW/LW),University of Connecticut,39,6,5,11,0.28,47,3
644,Red Savage (C),Michigan State University,20,5,6,11,0.55,6,6
645,Beanie Richter (F),Yale University,30,5,6,11,0.37,14,-2
646,Wyatt Schingoethe (C),Western Michigan University,31,5,6,11,0.35,2,10
647,Grayson Dietrich (C/LW),Niagara University,32,5,6,11,0.34,33,5
648,Joseph Grainda (LW),Stonehill College,33,5,6,11,0.33,15,2
649,Grant Ahcan (LW/RW),St. Cloud State University,36,5,6,11,0.31,16,-3
650,Kristóf Papp (C),Lindenwood University,29,4,7,11,0.38,2,-1
651,Hunter McCoy (F),Army (U.S. Military Academy),30,4,7,11,0.37,10,4
652,Zachary Aben (C/LW),Stonehill College,30,4,7,11,0.37,10,-14
653,Dimitri Mikrogiannakis (D),RIT (Rochester Inst. of Tech.),30,4,7,11,0.37,17,-6
654,Ross Mitton (RW/LW),University of Maine,32,4,7,11,0.34,38,10
655,John Druskinis (D),Lake Superior State University,36,4,7,11,0.31,30,-16
656,Casy Laylin (F),University of St. Thomas,38,4,7,11,0.29,8,-2
657,Mason Poolman (D),University of St. Thomas,38,4,7,11,0.29,13,-9
658,Ian Murphy (RW/C),University of Notre Dame,38,4,7,11,0.29,24,-5
659,Larry Keenan (D),UMass,40,4,7,11,0.28,16,16
660,Alex Konovalov (F),Princeton University,27,3,8,11,0.41,6,2
661,Jason Siedem (F),University of New Hampshire,32,3,8,11,0.34,4,-3
662,Eric Charpentier (D),Dartmouth College,33,3,8,11,0.33,26,14
663,Sean James (LW),Mercyhurst University,34,3,8,11,0.32,10,-10
664,Philippe Chapleau (D),St. Lawrence University,35,3,8,11,0.31,12,-17
665,Sam Court (D),Arizona State University,36,3,8,11,0.31,16,1
666,Tommi Männistö (RW),Michigan State University,37,3,8,11,0.30,6,13
667,Owen Baumgartner (D),Augustana University,21,2,9,11,0.52,21,4
668,Will Felicio (D),University of Michigan,25,2,9,11,0.44,2,12
669,Zach Schulz (D),University of Wisconsin,28,2,9,11,0.39,10,0
670,Connor Sullivan (D),Yale University,30,2,9,11,0.37,24,-12
671,Dylan Herzog (D),Yale University,30,2,9,11,0.37,33,-19
672,Lucas St-Louis (D),Harvard University,33,2,9,11,0.33,12,-6
673,Charles-Edward Tardif (C),Sacred Heart University,35,2,9,11,0.31,14,5
674,Ethan Gauer (D),University of St. Thomas,38,2,9,11,0.29,26,-6
675,Michael Sacco (F),Army (U.S. Military Academy),38,2,9,11,0.29,35,-7
676,Jack Budd (D),Canisius College,28,1,10,11,0.39,12,-8
677,Tynan Ewart (D),Northern Michigan University,34,1,10,11,0.32,4,-23
678,Evan McIntyre (D),Augustana University,35,1,10,11,0.31,24,7
679,Joshua Eernisse (F),University of Michigan,36,1,10,11,0.31,34,0
680,Charlie Leddy (D),Quinnipiac University,37,1,10,11,0.30,12,17
681,Viking Gustafsson Nyberg (D),University of Connecticut,39,1,10,11,0.28,27,9
682,Joel Kjellberg (D),Arizona State University,34,0,11,11,0.32,12,6
683,Trent Sambrook (D),Mercyhurst University,35,0,11,11,0.31,18,-21
684,Nolan Krenzen (D),University of Nebraska-Omaha,36,0,11,11,0.31,18,5
685,Michael Suda (D),Cornell University,36,0,11,11,0.31,24,12
686,Drew Fortescue (D),Boston College,36,0,11,11,0.31,42,28
687,Jacob Conrad (D),Lake Superior State University,28,6,4,10,0.36,4,8
688,Tyler Young (RW),Merrimack College,29,6,4,10,0.34,40,-4
689,Mason Langenbrunner (D),Harvard University,33,6,4,10,0.30,24,3
690,Ryan Sullivan (F),Miami University (Ohio),34,6,4,10,0.29,8,-11
691,Casper Nässén (RW/LW),Miami University (Ohio),34,6,4,10,0.29,10,-22
692,Callum Arnott (RW/C),University of Minnesota-Duluth,36,6,4,10,0.28,2,-16
693,Gavyn Thoreson (F),St. Cloud State University,36,6,4,10,0.28,36,-6
694,Max Dukovac (F),Miami University (Ohio),25,5,5,10,0.40,14,-14
695,Ty Naaykens (F),St. Lawrence University,27,5,5,10,0.37,19,-9
696,Chase McLane (C/RW),Colorado College,33,5,5,10,0.30,26,1
697,Mason McCormick (LW),Air Force Academy,35,5,5,10,0.29,41,-7
698,Connor Eddy (C),UMass-Lowell,36,5,5,10,0.28,32,7
699,Gavin Lindberg (F),Colorado College,37,5,5,10,0.27,8,-11
700,Chase Yoder (C/W),Providence College,37,5,5,10,0.27,18,5
701,William Horcoff (C),University of Michigan,18,4,6,10,0.56,6,-4
702,Charlie Lurie (F),University of Nebraska-Omaha,20,4,6,10,0.50,28,-7
703,Jacob Badal (LW),Ferris State University,25,4,6,10,0.40,6,1
704,Xavier Henry (D),University of Vermont,26,4,6,10,0.38,10,-12
705,Tyler Loughman (F),Lindenwood University,28,4,6,10,0.36,4,6
706,Dylan Finlay (D),University of Alaska-Anchorage,28,4,6,10,0.36,8,-11
707,Noah De la Durantaye (D),Princeton University,29,4,6,10,0.34,8,-12
708,Aidyn Hutchinson (F),Northern Michigan University,30,4,6,10,0.33,16,-6
709,Louis Jamernik (RW),University of North Dakota,30,4,6,10,0.33,29,3
710,George Krotiris (W),Robert Morris University,32,4,6,10,0.31,20,-6
711,McKay Hayes (C),Robert Morris University,33,4,6,10,0.30,11,-5
712,Christophe Fillion (F),Miami University (Ohio),34,4,6,10,0.29,16,-25
713,Carter Slaggert (LW/RW),University of Notre Dame,38,4,6,10,0.26,16,-7
714,Luc Laylin (F),University of St. Thomas,38,4,6,10,0.26,18,-5
715,Nathan McBrayer (D),Ohio State University,40,4,6,10,0.25,22,9
716,Brady Hunter (C),Stonehill College,27,3,7,10,0.37,8,-8
717,Nicholas Moldenhauer (C/RW),University of Michigan,29,3,7,10,0.34,4,1
718,Miles Gunty (F),Princeton University,29,3,7,10,0.34,4,-4
719,Patrik Satosaari (D),Bemidji State University,30,3,7,10,0.33,4,-8
720,Ryan Taylor (F),Clarkson University,31,3,7,10,0.32,4,-9
721,Ivan Zadvernyuk (F),Brown University,32,3,7,10,0.31,33,-1
722,Riley Brueck (F),Union College,33,3,7,10,0.30,6,-1
723,Andrius Kulbis-Marino (D),Long Island University,34,3,7,10,0.29,9,6
724,Fisher Scott (D),Colorado College,34,3,7,10,0.29,12,0
725,Trevor Kukkonen (F),Michigan Tech,35,3,7,10,0.29,6,-2
726,Caleb MacDonald (D),University of North Dakota,35,3,7,10,0.29,42,7
727,Garrett Szydlowski (RW),Western Michigan University,39,3,7,10,0.26,4,11
728,Linden Alger (D),UMass,40,3,7,10,0.25,10,5
729,Cruz Lucius (RW),Arizona State University,19,2,8,10,0.53,14,-7
730,Holden Doell (F),Ferris State University,31,2,8,10,0.32,12,-3
731,Charlie Banquier (D),Stonehill College,31,2,8,10,0.32,26,-1
732,Brendan Lamb (F),Mercyhurst University,33,2,8,10,0.30,4,-19
733,Will Dawson (F),Air Force Academy,34,2,8,10,0.29,10,0
734,Josef Mysak (D),Merrimack College,34,2,8,10,0.29,25,5
735,Nick Young (D),Union College,36,2,8,10,0.28,18,12
736,John Driscoll (D),Sacred Heart University,39,2,8,10,0.26,14,2
737,Jimmy Dowd (D),Penn State University,27,1,9,10,0.37,21,-5
738,Jack Anderson (D),Lindenwood University,32,1,9,10,0.31,14,-5
739,Eric Parker (D),Bowling Green State University,36,1,9,10,0.28,6,-4
740,Braden Doyle (D),Niagara University,37,1,9,10,0.27,12,4
741,Colton Huard (D),University of New Hampshire,35,0,10,10,0.29,22,-6
742,T.J. Schweighardt (D),UMass-Lowell,36,0,10,10,0.28,6,1
743,Brandon Chabrier (D),University of Maine,37,0,10,10,0.27,25,10
744,David Sacco (RW),Merrimack College,26,9,0,9,0.35,37,-3
745,Alexander Nordstrom (F),Michigan Tech,31,7,2,9,0.29,16,1
746,Cade Littler (C/RW),University of North Dakota,33,7,2,9,0.27,21,9
747,Brandon Svoboda (C/RW),Boston University,33,7,2,9,0.27,29,-9
748,Kienan Draper (RW),University of Michigan,33,7,2,9,0.27,37,-4
749,Ryan O'Reilly (W/C),Providence College,26,6,3,9,0.35,6,10
750,Max Martin (F),Bowling Green State University,32,6,3,9,0.28,10,1
751,Quinn Rudrud (F),Augustana University,32,6,3,9,0.28,27,-2
752,Mason Nevers (C),University of Minnesota,33,6,3,9,0.27,4,2
753,Patrick Schmiedlin (C),Lindenwood University,14,5,4,9,0.64,4,6
754,Kevin Anderson (F),Princeton University,28,5,4,9,0.32,27,-5
755,Cameron Johnson (C),Harvard University,31,5,4,9,0.29,2,-13
756,Ethan Bono (F),Merrimack College,33,5,4,9,0.27,6,0
757,Blake Bechen (F),University of Minnesota-Duluth,34,5,4,9,0.26,12,-3
758,Owen Lindmark (C/RW),University of Wisconsin,37,5,4,9,0.24,12,-13
759,Zack Sharp (D),Western Michigan University,42,5,4,9,0.21,12,19
760,Connor Caponi (F),University of Denver,42,5,4,9,0.21,65,8
761,Charlie Schoen (RW),Arizona State University,18,4,5,9,0.50,4,10
762,Matthew Johnson (F),University of Alaska-Anchorage,26,4,5,9,0.35,10,0
763,Charlie Gollob (C),Brown University,27,4,5,9,0.33,29,-2
764,Grady Hobbs (RW/LW),RIT (Rochester Inst. of Tech.),31,4,5,9,0.29,8,-18
765,Nicholas Degraves (F),Penn State University,33,4,5,9,0.27,8,3
766,Jack Smith (C/RW),University of Minnesota-Duluth,33,4,5,9,0.27,23,-10
767,Anthony Cliche (D),Northern Michigan University,34,4,5,9,0.26,14,-4
768,Mike Posma (C/LW),Boston College,37,4,5,9,0.24,16,4
769,Robby Newton (F),Colgate University,25,3,6,9,0.36,8,7
770,Kyler Kleven (C),Niagara University,26,3,6,9,0.35,10,-4
771,Owen Neuharth (C),Colgate University,29,3,6,9,0.31,8,3
772,Nic Belpedio (D),Colgate University,31,3,6,9,0.29,6,-10
773,Ivan Zivlak (D),Merrimack College,32,3,6,9,0.28,6,-1
774,Michael DeAngelo (C),Michigan State University,33,3,6,9,0.27,19,3
775,Sawyer Scholl (RW),University of Wisconsin,34,3,6,9,0.26,26,3
776,Brett Merner (D),Colgate University,35,3,6,9,0.26,0,8
777,Dakoda Rhéaume-Mullen (D),University of Michigan,35,3,6,9,0.26,8,-5
778,Jack Horbach (RW/C),University of Wisconsin,35,3,6,9,0.26,21,8
779,Nathan Oickle (D),Niagara University,37,3,6,9,0.24,14,9
780,Nick Carabin (D),University of Connecticut,39,3,6,9,0.23,16,7
781,Will Hillman (F),Minnesota State University (Mankato),39,3,6,9,0.23,23,7
782,Max Itagaki (F),Ferris State University,26,2,7,9,0.35,14,-6
783,Harper Bentz (RW),University of Minnesota-Duluth,27,2,7,9,0.33,4,3
784,Ian Carpentier (C),UMass-Lowell,27,2,7,9,0.33,8,4
785,Aidan Hreschuk (D),Boston College,33,2,7,9,0.27,21,9
786,Conner Hutchison (D),Miami University (Ohio),33,2,7,9,0.27,22,-10
787,Harrison Roy (F),Merrimack College,35,2,7,9,0.26,12,-13
788,Tanner Main (D),Bentley University,35,2,7,9,0.26,18,11
789,Reilly Connors (C/RW),St. Lawrence University,35,2,7,9,0.26,24,-14
790,David Posma (D),American International College,36,2,7,9,0.25,51,-1
791,Holt Oliphant (F),Air Force Academy,38,2,7,9,0.24,6,-1
792,Pierce Patterson (D),Army (U.S. Military Academy),38,2,7,9,0.24,12,-3
793,Samuel Groebner (D),Army (U.S. Military Academy),38,2,7,9,0.24,14,4
794,Cade Christenson (D),Penn State University,39,2,7,9,0.23,10,23
795,Ian Pierce (D),Dartmouth College,24,1,8,9,0.38,13,7
796,Cal Thomas (D),University of Minnesota,27,1,8,9,0.33,8,11
797,Marcus Broberg (D),University of Nebraska-Omaha,27,1,8,9,0.33,22,6
798,Mathew Shatsky (D),College of the Holy Cross,28,1,8,9,0.32,8,-5
799,Gabriel Westling (C/LW),St. Lawrence University,30,1,8,9,0.30,6,-13
800,Vincent Corcoran (D),Bemidji State University,30,1,8,9,0.30,8,5
801,Hagen Burrows (C/W),University of Denver,39,1,8,9,0.23,14,5
802,Thomas Messineo (D),University of Connecticut,39,1,8,9,0.23,20,19
803,Will Staring (D),Air Force Academy,39,1,8,9,0.23,26,-8
804,Jordan Venegoni (F),Lake Superior State University,28,0,9,9,0.32,6,-2
805,Chris Able (D),Ohio State University,32,0,9,9,0.28,6,10
806,Carter Schade (D),Penn State University,35,0,9,9,0.26,26,-1
807,Garrett Horsager (D),Bentley University,37,0,9,9,0.24,31,12
808,Carter Korpi (F),Union College,18,6,2,8,0.44,8,7
809,Noah Quinn (F),Bemidji State University,21,6,2,8,0.38,12,2
810,Ryan Duguay (RW/C),Northern Michigan University,24,6,2,8,0.33,4,-9
811,Pierson Brandon (D),UMass-Lowell,34,6,2,8,0.24,16,-1
812,Matthew Romer (F),Northern Michigan University,23,5,3,8,0.35,4,-8
813,Alexander Zetterberg (C),Boston University,26,5,3,8,0.31,2,0
814,Tyler DesRochers (D),Mercyhurst University,27,5,3,8,0.30,16,-9
815,Gunnar Thoreson (C),St. Lawrence University,33,5,3,8,0.24,8,-11
816,Grant Silianoff (RW),University of Notre Dame,38,5,3,8,0.21,18,-8
817,Marcus Pedersen (RW/LW),Michigan Tech,29,4,4,8,0.28,8,-2
818,Steven Townley (F),Dartmouth College,33,4,4,8,0.24,2,11
819,Josh Zinger (D),St. Cloud State University,33,4,4,8,0.24,16,-13
820,Matthew Vermaeten (F),Canisius College,35,4,4,8,0.23,2,-5
821,Arvils Bergmanis (D),RPI (Rensselaer Polytech. Inst.),35,4,4,8,0.23,22,-10
822,Daniel Baldassarra (C),Long Island University,17,3,5,8,0.47,2,8
823,Zach Nicolas (F),Stonehill College,20,3,5,8,0.40,2,-7
824,Joel Lehtinen (F),Stonehill College,27,3,5,8,0.30,12,1
825,Aleksi Kivioja (C/W),Providence College,28,3,5,8,0.29,10,8
826,Luc Pelletier (LW),Princeton University,29,3,5,8,0.28,35,-7
827,Michael Callow (RW/LW),Harvard University,30,3,5,8,0.27,14,2
828,Henry Nelson (D),University of Notre Dame,30,3,5,8,0.27,32,0
829,Ryan Alexander (C/LW),Arizona State University,31,3,5,8,0.26,6,11
830,Tanner Edwards (LW/C),University of Alaska-Anchorage,31,3,5,8,0.26,58,-6
831,Jarred White (C),University of Alaska-Anchorage,32,3,5,8,0.25,17,-4
832,D.J. Hart (D),Union College,32,3,5,8,0.25,33,1
833,Cody Monds (RW/C),Robert Morris University,33,3,5,8,0.24,2,-7
834,Thomas Sinclair (C),University of Vermont,33,3,5,8,0.24,21,-12
835,Carter Loney (C),University of Minnesota-Duluth,33,3,5,8,0.24,40,-10
836,Patrick Johnson (F),Robert Morris University,34,3,5,8,0.24,24,-5
837,Jesse Tucker (C),Northern Michigan University,34,3,5,8,0.24,26,-25
838,John Mittelstadt (F),University of Minnesota,35,3,5,8,0.23,0,5
839,Josh Luedtke (D),St. Cloud State University,36,3,5,8,0.22,10,-14
840,Tyler Paquette (RW/C),Penn State University,38,3,5,8,0.21,12,-11
841,Kash Rasmussen (F),Canisius College,14,2,6,8,0.57,6,5
842,Uula Ruikka (D),Augustana University,24,2,6,8,0.33,12,5
843,Barrett Brooks (RW),Mercyhurst University,26,2,6,8,0.31,2,-15
844,Cooper Wylie (D),St. Cloud State University,26,2,6,8,0.31,24,1
845,Nicholas Bernardo (D),Long Island University,27,2,6,8,0.30,10,3
846,Adam Ingram (C),St. Cloud State University,29,2,6,8,0.28,12,-4
847,Blake Humphrey (C),Lake Superior State University,30,2,6,8,0.27,2,-1
848,Aiden Celebrini (D),Boston University,31,2,6,8,0.26,14,8
849,Philip Törnqvist (D),University of Vermont,33,2,6,8,0.24,4,-7
850,Jackson Niedermayer (LW),Bowling Green State University,33,2,6,8,0.24,12,-9
851,Connor Sweeney (F),University of New Hampshire,35,2,6,8,0.23,8,-7
852,Mitchell Wolfe (D),Bemidji State University,38,2,6,8,0.21,12,-8
853,Garrett Brown (D),University of Denver,42,2,6,8,0.19,33,9
854,Luca Leighton (F),Long Island University,23,1,7,8,0.35,22,5
855,Caelum Dick (D),University of Alaska-Fairbanks,25,1,7,8,0.32,10,4
856,Brett Roloson (F),Niagara University,26,1,7,8,0.31,0,1
857,Nicolas Petruolo (D),College of the Holy Cross,27,1,7,8,0.30,54,13
858,Ryan O'Connell (C),Merrimack College,28,1,7,8,0.29,18,-5
859,Andy Reist (F),Niagara University,32,1,7,8,0.25,16,-12
860,Will Svenddal (D),Augustana University,33,1,7,8,0.24,8,2
861,Nicholas Cafarelli (F),RIT (Rochester Inst. of Tech.),33,1,7,8,0.24,34,-6
862,Colin Ralph (D),St. Cloud State University,35,1,7,8,0.23,20,-4
863,Michael Hagens (D),Boston College,37,1,7,8,0.22,5,5
864,Campbell Cichosz (D),Minnesota State University (Mankato),37,1,7,8,0.22,8,22
865,Brody Gagno (D),College of the Holy Cross,39,1,7,8,0.21,40,15
866,Kent Anderson (D),University of Denver,44,1,7,8,0.18,14,13
867,Alexander Malinowski (LW/RW),American International College,25,0,8,8,0.32,6,-8
868,Connor McGrath (C),Ferris State University,26,0,8,8,0.31,8,-8
869,Theo Wallberg (D),Ohio State University,27,0,8,8,0.30,10,13
870,Jimmy Doyle (RW),Bentley University,32,0,8,8,0.25,6,3
871,Nick Williams (D),Michigan Tech,34,0,8,8,0.24,10,7
872,Lachlan Getz (D),College of the Holy Cross,38,0,8,8,0.21,32,5
873,Kyle Penney (C),Cornell University,25,6,1,7,0.28,15,8
874,Tanner Latsch (C),Northern Michigan University,22,5,2,7,0.32,6,-12
875,Jens Richards (F),University of Vermont,26,5,2,7,0.27,6,-6
876,Simone Dadiè (F),Colgate University,31,5,2,7,0.23,8,-2
877,Gavin Gulash (F),Robert Morris University,33,5,2,7,0.21,33,1
878,Andrew DeCarlo (F),Air Force Academy,35,5,2,7,0.20,31,-5
879,Brett Moravec (F),Minnesota State University (Mankato),37,5,2,7,0.19,16,3
880,Sixten Jennersjö (LW),Long Island University,16,4,3,7,0.44,4,1
881,Jake Black (F),Bentley University,22,4,3,7,0.32,6,-1
882,Ty Hipkin (F),Lindenwood University,29,4,3,7,0.24,14,-5
883,Ethan Zielke (F),Lindenwood University,30,4,3,7,0.23,12,-2
884,Ryan Botterill (F),University of Wisconsin,31,4,3,7,0.23,2,-12
885,Braden Birnie (F),University of Alaska-Fairbanks,32,4,3,7,0.22,12,-8
886,Blake Mesenburg (C/LW),Miami University (Ohio),34,4,3,7,0.21,12,-16
887,Ryan McGuire (C/RW),Northeastern University,37,4,3,7,0.19,14,-9
888,Noah Carlin (D),Niagara University,37,4,3,7,0.19,18,1
889,Michael Cameron (C),UMass,21,3,4,7,0.33,4,-2
890,Jake Bongo (F),Sacred Heart University,22,3,4,7,0.32,0,4
891,Benji Eckerle (F),Arizona State University,24,3,4,7,0.29,12,0
892,Chase Davis (F),Bentley University,25,3,4,7,0.28,4,0
893,Carter Batchelder (C),Lake Superior State University,26,3,4,7,0.27,10,-8
894,Owen Kim (F),College of the Holy Cross,26,3,4,7,0.27,39,-3
895,Casey McDonald (F),American International College,27,3,4,7,0.26,25,-2
896,Anthony Yu (F),Air Force Academy,29,3,4,7,0.24,8,-7
897,Cole Melady (F),Stonehill College,29,3,4,7,0.24,14,-3
898,Briggs Gammill (F),Yale University,30,3,4,7,0.23,18,-9
899,Dylan Moulton (D),Miami University (Ohio),33,3,4,7,0.21,16,-28
900,Donte Lawson (F),Bemidji State University,36,3,4,7,0.19,2,-2
901,Mitchell Digby (D),Air Force Academy,36,3,4,7,0.19,4,6
902,Mason Salquist (F),St. Cloud State University,36,3,4,7,0.19,16,-7
903,Tucker Hodgson (D),Bentley University,40,3,4,7,0.18,22,5
904,Nick Sajevic (F),Air Force Academy,20,2,5,7,0.35,4,0
905,Ethan Lund (D),Niagara University,27,2,5,7,0.26,14,10
906,Connor Pelc (RW),Mercyhurst University,28,2,5,7,0.25,29,-15
907,Luke Pakulak (F),Clarkson University,30,2,5,7,0.23,10,-3
908,Will Skahan (D),Boston College,30,2,5,7,0.23,10,6
909,Jack Brandt (F),Colgate University,31,2,5,7,0.23,40,-4
910,Nicholas Beneteau (C/RW),St. Lawrence University,32,2,5,7,0.22,6,-16
911,Isack Bandu (D),St. Lawrence University,32,2,5,7,0.22,27,-12
912,Jake McLean (F),Bemidji State University,33,2,5,7,0.21,2,-6
913,Leo Chambers (C),Stonehill College,33,2,5,7,0.21,10,-1
914,Austin Jouppi (F),Bemidji State University,33,2,5,7,0.21,12,-9
915,Nick Nardecchia (RW),Ferris State University,33,2,5,7,0.21,14,-6
916,Drake Burgin (D),St. Lawrence University,35,2,5,7,0.20,14,-21
917,Thomas Weis (C),Ohio State University,35,2,5,7,0.20,19,8
918,Jarod Crespo (D),Penn State University,36,2,5,7,0.19,10,-10
919,Hank Kempf (D),Cornell University,36,2,5,7,0.19,18,4
920,Oskar Komarov (RW),University of Maine,37,2,5,7,0.19,4,3
921,Brasen Boser (D),Arizona State University,37,2,5,7,0.19,8,5
922,Ty Brassington (D),Clarkson University,38,2,5,7,0.18,2,5
923,Tony Follmer (D),Bemidji State University,38,2,5,7,0.18,16,-9
924,Garett Drotts (LW),Augustana University,20,1,6,7,0.35,8,3
925,Greg Japchen (D),Robert Morris University,25,1,6,7,0.28,10,-5
926,Dane Montgomery (D/RW),University of North Dakota,27,1,6,7,0.26,8,-4
927,Vladislav Lukashevich (D),Michigan State University,29,1,6,7,0.24,4,11
928,Kieran O'Hearn (D),Yale University,29,1,6,7,0.24,32,-5
929,Zakary Karpa (C/LW),Harvard University,31,1,6,7,0.23,8,-6
930,Michael Rubin (D),Sacred Heart University,31,1,6,7,0.23,10,9
931,Justin Gibson (D),Stonehill College,32,1,6,7,0.22,0,-4
932,Matthew Fusco (D),Dartmouth College,32,1,6,7,0.22,4,-3
933,Tony Andreozzi (D),Brown University,32,1,6,7,0.22,6,-3
934,Aiden VanRooyan (D),Sacred Heart University,32,1,6,7,0.22,10,8
935,Breck McKinley (D),Bowling Green State University,35,1,6,7,0.20,14,4
936,Evan Stella (D),American International College,35,1,6,7,0.20,16,-19
937,Casey Aman (D),Penn State University,36,1,6,7,0.19,10,-1
938,Lauri Sertti (D),American International College,37,1,6,7,0.19,6,1
939,Ryan Helliwell (D),University of Notre Dame,37,1,6,7,0.19,39,1
940,Patrick Geary (D),Michigan State University,37,1,6,7,0.19,43,4
941,Kaelan Taylor (D),Clarkson University,39,1,6,7,0.18,10,15
942,Caleb Price (D),Mercyhurst University,24,0,7,7,0.29,0,-19
943,Ryan Beck (C),Colorado College,27,0,7,7,0.26,8,-13
944,Brendan Miles (D),Union College,29,0,7,7,0.24,10,0
945,Gabriel Lunn (D),Robert Morris University,29,0,7,7,0.24,10,-5
946,Ren Morque (D),Air Force Academy,39,0,7,7,0.18,2,9
947,Conor Lovett (F),University of New Hampshire,35,5,1,6,0.17,10,-2
948,Jan Lasak (RW),St. Lawrence University,16,4,2,6,0.38,4,-7
949,Carter Randklev (F),Bemidji State University,18,4,2,6,0.33,6,3
950,Tyler Coffey (F),Colorado College,23,4,2,6,0.26,0,-3
951,Owen Mehlenbacher (C),University of Wisconsin,25,4,2,6,0.24,2,-2
952,Matthew Rickard (D),University of Alaska-Fairbanks,25,4,2,6,0.24,18,-6
953,Will Arquiett (F),St. Lawrence University,27,4,2,6,0.22,10,-5
954,Philippe Jacques (C),RIT (Rochester Inst. of Tech.),34,4,2,6,0.18,6,-18
955,Ryan Spinale (F),Colgate University,34,4,2,6,0.18,69,-14
956,Tristan Amonte (F),Boston University,38,4,2,6,0.16,19,-2
957,Haden Kruse (F),University of Alaska-Fairbanks,15,3,3,6,0.40,2,3
958,Matteo Disipio (RW),Mercyhurst University,16,3,3,6,0.38,2,-4
959,Jack Silich (F),Ferris State University,20,3,3,6,0.30,6,-4
960,Clint Levens (C),Providence College,22,3,3,6,0.27,18,2
961,Crossley Stewart (D),RIT (Rochester Inst. of Tech.),24,3,3,6,0.25,21,0
962,Joey Molenaar (F),University of Minnesota-Duluth,31,3,3,6,0.19,6,-8
963,Kristaps Skrastins (C),University of New Hampshire,32,3,3,6,0.19,4,-5
964,Ryan Shostak (F),Brown University,32,3,3,6,0.19,14,-2
965,Hugh Larkin (RW),University of Connecticut,32,3,3,6,0.19,37,-4
966,Jérémie Payant (C),RPI (Rensselaer Polytech. Inst.),33,3,3,6,0.18,6,-7
967,Owen DuBois (F),Air Force Academy,34,3,3,6,0.18,23,-9
968,Drew Sutton (F),Union College,35,3,3,6,0.17,2,-10
969,William Smith (D),Ohio State University,36,3,3,6,0.17,29,-2
970,Grant Hindman (D),Lake Superior State University,36,3,3,6,0.17,30,-14
971,Matvei Kabanov (LW),Bowling Green State University,13,2,4,6,0.46,2,0
972,Kyle Heath (F),Stonehill College,21,2,4,6,0.29,2,-2
973,Karter McNarland (F),University of Alaska-Anchorage,23,2,4,6,0.26,4,-1
974,Robert Kincaid (D),Canisius College,24,2,4,6,0.25,0,-6
975,Jayden Sison (RW),Princeton University,24,2,4,6,0.25,10,-5
976,Jérémi Tremblay (F),Sacred Heart University,24,2,4,6,0.25,21,8
977,Nathan Lewis (LW),Ohio State University,28,2,4,6,0.21,2,2
978,Nikolai Jenson (D),University of New Hampshire,28,2,4,6,0.21,33,0
979,Jakob Peterson (D),Northern Michigan University,29,2,4,6,0.21,12,-14
980,Jan Olenginski (D),St. Lawrence University,30,2,4,6,0.20,10,-4
981,Julian Frias (F),Yale University,30,2,4,6,0.20,12,-12
982,Xavier Alexandre Jean-Louis (D),Ferris State University,30,2,4,6,0.20,14,2
983,Tomas Machu (D),Providence College,30,2,4,6,0.20,27,2
984,Oliver Salo (F),Bentley University,31,2,4,6,0.19,8,3
985,Drew Kuzma (F),Lindenwood University,32,2,4,6,0.19,19,-12
986,Gunnar VanDamme (D),University of Alaska-Anchorage,34,2,4,6,0.18,12,-12
987,Dylan Wegner (F),Army (U.S. Military Academy),34,2,4,6,0.18,16,-8
988,Keaton Peters (F),Penn State University,35,2,4,6,0.17,6,-13
989,Tyler Catalano (C/RW),Cornell University,36,2,4,6,0.17,26,0
990,Jack Robilotti (D),UMass-Lowell,36,2,4,6,0.17,32,6
991,Jake Sondreal (C),Boston College,36,2,4,6,0.17,36,6
992,Jayden Jubenvill (D),University of North Dakota,37,2,4,6,0.16,29,8
993,Jordan Power (D),Minnesota State University (Mankato),37,2,4,6,0.16,31,8
994,Wilhelm Forsberg (RW),American International College,20,1,5,6,0.30,6,0
995,Cody Croal (LW),University of North Dakota,22,1,5,6,0.27,12,2
996,Nick Trela (F),Long Island University,22,1,5,6,0.27,23,2
997,Hughie Hooker (D),Yale University,26,1,5,6,0.23,10,-23
998,Logan Acheson (D),University of Alaska-Anchorage,27,1,5,6,0.22,4,-2
999,Jack Larrigan (RW/LW),University of Notre Dame,29,1,5,6,0.21,4,-11
1000,Matthew Morden (D),Harvard University,31,1,5,6,0.19,6,-1
1001,Tyler Procious (D),American International College,32,1,5,6,0.19,8,-8
1002,Joe Solimine (C),College of the Holy Cross,32,1,5,6,0.19,12,-1
1003,Kyle Bettens (RW/C),University of Minnesota-Duluth,32,1,5,6,0.19,12,-9
1004,Steven Bellini (D),Minnesota State University (Mankato),33,1,5,6,0.18,4,5
1005,Luca Fantilli (D),University of Michigan,34,1,5,6,0.18,8,-5
1006,Luke Weilandt (F),Merrimack College,35,1,5,6,0.17,14,-8
1007,Ben Wozney (D),Bowling Green State University,36,1,5,6,0.17,19,1
1008,Luke LaMaster (D),University of Alaska-Fairbanks,27,0,6,6,0.22,10,9
1009,Luis Lindner (D/F),University of New Hampshire,28,0,6,6,0.21,4,3
1010,Ethan Straky (D),Colorado College,32,0,6,6,0.19,24,-6
1011,Kennedy O'Connor (D),UMass,34,0,6,6,0.18,8,7
1012,Gabe Blanchard (D),Sacred Heart University,38,0,6,6,0.16,31,-2
1013,Mason Wheeler (D),Minnesota State University (Mankato),39,0,6,6,0.15,13,22
1014,Chad Muller (RW),Long Island University,12,4,1,5,0.42,14,6
1015,Porter Schachle (F),University of Alaska-Anchorage,21,4,1,5,0.24,20,-4
1016,Marek Hejduk (F),Harvard University,26,4,1,5,0.19,8,-10
1017,Kalen Szeto (F),Yale University,27,4,1,5,0.19,4,-14
1018,Nick Portz (F),St. Cloud State University,33,4,1,5,0.15,12,-11
1019,Brady Berard (C),Boston College,35,4,1,5,0.14,10,-4
1020,Killian Kiecker-Olson (C),Canisius College,22,3,2,5,0.23,6,11021,Ethan Aucoin (F),St. Cloud State University,23,3,2,5,0.22,6,-3
1022,Nicholas Niemo (F),University of Maine,23,3,2,5,0.22,21,0
1023,Trevor LeDonne (D),Robert Morris University,23,3,2,5,0.22,22,-4
1024,Brody Mortensen (D),Lindenwood University,24,3,2,5,0.21,10,-5
1025,Owen Baker (RW),Michigan Tech,33,3,2,5,0.15,2,-8
1026,Daniel Ebrahim (LW),Sacred Heart University,33,3,2,5,0.15,8,-1
1027,Cole Gordon (F),Arizona State University,34,3,2,5,0.15,4,-4
1028,Connor Joyce (C),Boston College,35,3,2,5,0.14,2,4
1029,Tyler Mahan (LW),RIT (Rochester Inst. of Tech.),35,3,2,5,0.14,15,-4
1030,Jakob Stender (D),Minnesota State University (Mankato),37,3,2,5,0.14,13,21031,Tom Leppä (C),Michigan Tech,16,2,3,5,0.31,6,2
1032,Noah Powell (RW),Ohio State University,17,2,3,5,0.29,4,0
1033,Tyler Rubin (D),Princeton University,17,2,3,5,0.29,12,0
1034,Michael La Starza (LW),University of Vermont,18,2,3,5,0.28,4,-6
1035,Joey Potter (D),University of Alaska-Anchorage,18,2,3,5,0.28,12,-7
1036,Thomas Pichette (C),University of Maine,19,2,3,5,0.26,0,1
1037,Drew Vieten (F),Niagara University,20,2,3,5,0.25,4,6
1038,Braden Fischer (LW),University of Minnesota-Duluth,20,2,3,5,0.25,8,0
1039,Matt Corbet (F),Ferris State University,20,2,3,5,0.25,12,-4
1040,Daniel Laatsch (D),University of Wisconsin,22,2,3,5,0.23,2,11041,David Hymovitch (F),Arizona State University,23,2,3,5,0.22,0,1
1042,August Falloon (C),University of Minnesota,24,2,3,5,0.21,0,0
1043,Jaksen Panzer (F),Bemidji State University,26,2,3,5,0.19,2,-7
1044,Médrick Bolduc (F),Northern Michigan University,26,2,3,5,0.19,34,-13
1045,Aiden Westin (F),University of Alaska-Anchorage,27,2,3,5,0.19,6,-7
1046,Hampus Rydqvist (D),Miami University (Ohio),28,2,3,5,0.18,10,-12
1047,Jacob Jeannette (RW),Union College,29,2,3,5,0.17,12,-3
1048,William Lawson-Body (F),University of Alaska-Fairbanks,31,2,3,5,0.16,2,5
1049,James Duerr (F),UMass,31,2,3,5,0.16,6,1
1050,Alexander Bales (D),Providence College,32,2,3,5,0.16,10,2
1051,Adam Kleber (D),University of Minnesota-Duluth,33,2,3,5,0.15,13,-9
1052,Devlin O'Brien (LW),Stonehill College,33,2,3,5,0.15,37,-3
1053,Ryan Smith (RW),Quinnipiac University,34,2,3,5,0.15,21,-10
1054,Brad McNeil (F),RPI (Rensselaer Polytech. Inst.),35,2,3,5,0.14,2,-4
1055,James Goffredo (D),RPI (Rensselaer Polytech. Inst.),35,2,3,5,0.14,20,-9
1056,Tommy Pasanen (D),Bowling Green State University,35,2,3,5,0.14,37,1
1057,Easton Zueger (D),Army (U.S. Military Academy),36,2,3,5,0.14,28,-8
1058,Luke Farthing (D),Canisius College,15,1,4,5,0.33,10,-8
1059,Bodie Nobes (D),University of Maine,21,1,4,5,0.24,4,9
1060,Tommy Middleton (F),Colorado College,21,1,4,5,0.24,8,-7
1061,Ryan Fine (F),Harvard University,24,1,4,5,0.21,2,-9
1062,Trevor Griebel (D/F),Merrimack College,25,1,4,5,0.20,19,-9
1063,Carter Patterson (D),Canisius College,28,1,4,5,0.18,31,-1
1064,Ethan Szmagaj (D),Arizona State University,29,1,4,5,0.17,0,0
1065,Matthew Perkins (C),University of Minnesota-Duluth,29,1,4,5,0.17,14,-7
1066,Seth Fyten (F),Bowling Green State University,30,1,4,5,0.17,22,-3
1067,Brett Bliss (D),Brown University,31,1,4,5,0.16,10,3
1068,Bryan Huggins (D),Lake Superior State University,32,1,4,5,0.16,12,-1
1069,Mitchell Allard (LW),Lindenwood University,32,1,4,5,0.16,33,1
1070,Danny Ciccarello (F),Northern Michigan University,33,1,4,5,0.15,12,-10
1071,Cam Gaudette (D),Stonehill College,33,1,4,5,0.15,21,0
1072,Lauri Raiman (C/W),Michigan Tech,35,1,4,5,0.14,4,1
1073,Viktor Hurtig (D),Michigan Tech,35,1,4,5,0.14,10,-7
1074,William Magnuson (D),Bemidji State University,35,1,4,5,0.14,21,-10
1075,Joseph Pierce (D),University of Minnesota-Duluth,36,1,4,5,0.14,50,5
1076,Jack Sparkes (D),Clarkson University,38,1,4,5,0.13,50,1
1077,Alex Gomez (C/W),University of Alaska-Anchorage,16,0,5,5,0.31,2,5
1078,Nick Roukounakis (LW),Boston University,21,0,5,5,0.24,12,-1
1079,John Dalton (D),University of Maine,21,0,5,5,0.24,21,-3
1080,Everett Pietila (F),Lake Superior State University,25,0,5,5,0.20,10,-4
1081,Brady Yakesh (D),Lindenwood University,27,0,5,5,0.19,16,-4
1082,Ethan Elias (D),University of St. Thomas,29,0,5,5,0.17,2,-1
1083,Jack Silverberg (F),Dartmouth College,29,0,5,5,0.17,15,9
1084,Adam Cardona (D),University of Alaska-Fairbanks,31,0,5,5,0.16,32,-3
1085,Sean Vlasich (D),Army (U.S. Military Academy),33,0,5,5,0.15,6,1
1086,Colton Cameron (D),Bentley University,38,0,5,5,0.13,10,9
1087,Beau Janzig (D),Air Force Academy,40,0,5,5,0.13,6,-7
1088,Nate Morgan (F),Dartmouth College,17,4,0,4,0.24,0,4
1089,Anton Rubtsov (F),University of Alaska-Fairbanks,13,3,1,4,0.31,8,0
1090,Chase LaPinta (F),University of Nebraska-Omaha,19,3,1,4,0.21,4,-4
1091,Cade Ahrenholz (RW),University of Alaska-Fairbanks,24,3,1,4,0.17,41,-3
1092,Michael Hodge (F),College of the Holy Cross,25,3,1,4,0.16,2,3
1093,Spencer Bell (F),St. Lawrence University,32,3,1,4,0.13,20,-5
1094,Stefano Bottini (LW/RW),Canisius College,33,3,1,4,0.12,23,-4
1095,Ethan Wolthers (F),Western Michigan University,9,2,2,4,0.44,2,-1
1096,Hunter Longhi (LW),American International College,13,2,2,4,0.31,4,-1
1097,Jacob MacDonald (LW/C),UMass-Lowell,14,2,2,4,0.29,4,-2
1098,Liam Watkins (F),University of Nebraska-Omaha,15,2,2,4,0.27,0,-7
1099,Luke Johnson (LW/C),University of Alaska-Fairbanks,15,2,2,4,0.27,4,1
1100,Matt Argentina (C),Northern Michigan University,16,2,2,4,0.25,10,-2
1101,Ray Murakami (D),Niagara University,17,2,2,4,0.24,2,6
1102,Kai Daniells (F),Princeton University,18,2,2,4,0.22,2,-8
1103,Ray Fust (LW/RW),Clarkson University,19,2,2,4,0.21,2,-3
1104,Nathan Sullivan (F),RPI (Rensselaer Polytech. Inst.),21,2,2,4,0.19,0,1
1105,Jacob Napier (D),Colgate University,27,2,2,4,0.15,6,-3
1106,Ty Whyte (C),RIT (Rochester Inst. of Tech.),27,2,2,4,0.15,26,-2
1107,Daniel Sambuco (F),University of Vermont,27,2,2,4,0.15,46,0
1108,Connor Marritt (F),University of Alaska-Anchorage,28,2,2,4,0.14,4,-4
1109,Kyle Aucoin (D),Harvard University,28,2,2,4,0.14,8,-3
1110,Luke Antonacci (D),University of Maine,30,2,2,4,0.13,6,10
1111,Andrew Strathmann (D),University of North Dakota,30,2,2,4,0.13,24,0
1112,Braden Rourke (RW),Robert Morris University,30,2,2,4,0.13,36,-6
1113,Will Troutwine (D),College of the Holy Cross,31,2,2,4,0.13,0,3
1114,Artyom Borshyov (D),Lindenwood University,32,2,2,4,0.13,14,6
1115,Nicholas Van Tassell (C),UMass,37,2,2,4,0.11,11,-10
1116,Nick Rhéaume (LW/C),Northeastern University,37,2,2,4,0.11,39,-16
1117,Rhys Bentham (D),Yale University,8,1,3,4,0.50,2,-1
1118,Nick Michel (F),University of Minnesota,10,1,3,4,0.40,17,5
1119,Michael Feenstra (D),Miami University (Ohio),13,1,3,4,0.31,16,-7
1120,Cayden Casey (F),St. Lawrence University,13,1,3,4,0.31,17,6
1121,Paul Minnehan (F),Sacred Heart University,14,1,3,4,0.29,2,0
1122,Brennan Nelson (F),Long Island University,16,1,3,4,0.25,26,1
1123,Warren Clark (D),St. Cloud State University,20,1,3,4,0.20,0,-2
1124,Garrett Sundquist (D),Sacred Heart University,20,1,3,4,0.20,2,8
1125,Christopher Lie (D),Ferris State University,20,1,3,4,0.20,6,-6
1126,Spencer Cox (D/C),Miami University (Ohio),20,1,3,4,0.20,19,-16
1127,Adam Zlnka (W/C),Bowling Green State University,21,1,3,4,0.19,12,6
1128,Jaedon Kerr (D),University of Notre Dame,22,1,3,4,0.18,6,2
1129,Alex Power (C),Quinnipiac University,23,1,3,4,0.17,0,0
1130,Drew Hockley (D),Quinnipiac University,23,1,3,4,0.17,6,3
1131,Nathan Rickey (D),University of Alaska-Fairbanks,24,1,3,4,0.17,6,1
1132,Drew Garzone (C),Princeton University,25,1,3,4,0.16,6,3
1133,Joe Palodichuk (D),University of Wisconsin,25,1,3,4,0.16,8,-7
1134,Joseph Messina (D),Union College,26,1,3,4,0.15,4,1
1135,Noah Ellis (D),University of Nebraska-Omaha,26,1,3,4,0.15,8,-10
1136,Nick Traggio (D),Brown University,26,1,3,4,0.15,10,3
1137,David Andreychuk (C/LW),Yale University,27,1,3,4,0.15,22,-19
1138,Carson Buydens (C),Princeton University,29,1,3,4,0.14,24,-5
1139,Ian Devlin (D),Princeton University,30,1,3,4,0.13,12,3
1140,Tyler Nasca (D),Mercyhurst University,31,1,3,4,0.13,4,-9
1141,Jimmy Jurcev (D),University of Notre Dame,31,1,3,4,0.13,10,-8
1142,Spencer Smith (C),Mercyhurst University,32,1,3,4,0.13,6,-13
1143,Joe Prouty (D),Lindenwood University,32,1,3,4,0.13,24,-8
1144,Jacob Slipec (F),University of Nebraska-Omaha,33,1,3,4,0.12,24,-10
1145,Rihards Simanovics (D),Miami University (Ohio),34,1,3,4,0.12,10,-15
1146,Jack Reimann (F),St. Cloud State University,35,1,3,4,0.11,18,-9
1147,Andy Moore (F),Northeastern University,36,1,3,4,0.11,10,-1
1148,Nico DeVita (D),Ferris State University,36,1,3,4,0.11,21,-2
1149,Brenden Olson (D),Minnesota State University (Mankato),37,1,3,4,0.11,8,5
1150,Connor Kelley (D),Providence College,37,1,3,4,0.11,24,4
1151,Shawn O'Donnell (F),Clarkson University,39,1,3,4,0.10,16,-3
1152,Rhys Chiddenton (LW),Bemidji State University,17,0,4,4,0.24,4,-2
1153,Jake Dunlap (F),Ohio State University,21,0,4,4,0.19,2,1
1154,Peter Kramer (F),Bentley University,22,0,4,4,0.18,8,2
1155,Bayard Hall (D),Yale University,27,0,4,4,0.15,12,-8
1156,Jon Bell (D),Army (U.S. Military Academy),27,0,4,4,0.15,14,-5
1157,Karl Falk (D),St. Cloud State University,28,0,4,4,0.14,6,-3
1158,Colby Enns (D),Merrimack College,30,0,4,4,0.13,10,-7
1159,Joe Gramer (D),University of Nebraska-Omaha,33,0,4,4,0.12,4,1
1160,Kevin Scott (D),RIT (Rochester Inst. of Tech.),35,0,4,4,0.11,14,-19
1161,Brady Ziemer (D),Augustana University,35,0,4,4,0.11,16,-5
1162,Kasper Vähärautio (D),Michigan Tech,36,0,4,4,0.11,2,-7
1163,Jack Phelan (D),University of Wisconsin,36,0,4,4,0.11,14,0
1164,Ty Murchison (D),Arizona State University,37,0,4,4,0.11,48,6
1165,Dean Bauchiero (W),Brown University,18,3,0,3,0.17,19,0
1166,Salvatore Guzzo (F),Harvard University,21,3,0,3,0.14,8,-3
1167,Rasmus Larsson (D),Northern Michigan University,29,3,0,3,0.10,14,-9
1168,Sutter Muzzatti (F),RPI (Rensselaer Polytech. Inst.),10,2,1,3,0.30,8,-7
1169,Hunter Andrew (F),Canisius College,16,2,1,3,0.19,6,2
1170,Alexander Lundman (RW/LW),Lindenwood University,17,2,1,3,0.18,6,-6
1171,Ryder Matter (F),Michigan Tech,19,2,1,3,0.16,4,-2
1172,Grant Docter (D),University of St. Thomas,25,2,1,3,0.12,4,-5
1173,Cameron O'Neill (RW),UMass,27,2,1,3,0.11,6,1
1174,Kai Greaves (D),Princeton University,29,2,1,3,0.10,2,-10
1175,Jake Higgins (D),Northeastern University,36,2,1,3,0.08,4,-3
1176,Girts Silkalns (F),UMass-Lowell,10,1,2,3,0.30,2,0
1177,Alexander Tell (C),University of St. Thomas,10,1,2,3,0.30,4,-3
1178,Braiden Clark (C),Providence College,16,1,2,3,0.19,2,4
1179,Sam Jacobs (F),Air Force Academy,17,1,2,3,0.18,2,1
1180,Mitchell Becker (D),UMass-Lowell,17,1,2,3,0.18,8,-5
1181,William Howard (F),Augustana University,18,1,2,3,0.17,6,-4
1182,Adam Parsons (F),University of Alaska-Anchorage,21,1,2,3,0.14,2,-5
1183,Jack Agnew (D),RPI (Rensselaer Polytech. Inst.),21,1,2,3,0.14,4,-5
1184,Ben Anderson (F),University of Alaska-Anchorage,21,1,2,3,0.14,41,-7
1185,Davis Goukler (D),University of Alaska-Anchorage,22,1,2,3,0.14,4,-4
1186,Jackson Nieuwendyk (F),Canisius College,22,1,2,3,0.14,6,-5
1187,Jayden Davis (C/LW),University of Notre Dame,22,1,2,3,0.14,8,-5
1188,Henry Bartle (F),Michigan Tech,22,1,2,3,0.14,8,-3
1189,Tanner Hartman (F),Brown University,23,1,2,3,0.13,6,2
1190,Thor Byfuglien (D),St. Cloud State University,24,1,2,3,0.13,4,-13
1191,Iisai Pesonen (C),Yale University,25,1,2,3,0.12,10,-5
1192,Johnny Wescoe (F),Niagara University,26,1,2,3,0.12,2,-4
1193,Adam Jeffery (LW),RIT (Rochester Inst. of Tech.),26,1,2,3,0.12,6,-11
1194,Jake Beaune (D),Mercyhurst University,26,1,2,3,0.12,36,-16
1195,Zach Michaelis (C),Northern Michigan University,27,1,2,3,0.11,0,-13
1196,Carson Dyck (F),Penn State University,28,1,2,3,0.11,0,-1
1197,Michael Cataldo (C),Brown University,28,1,2,3,0.11,4,1
1198,Braden Blace (D),Quinnipiac University,28,1,2,3,0.11,4,5
1199,Fyodor Nikolayenya (F),University of Alaska-Fairbanks,28,1,2,3,0.11,20,3
1200,Zane Demsey (D),Miami University (Ohio),28,1,2,3,0.11,40,-11
1201,Garrett Pinoniemi (C),University of Nebraska-Omaha,29,1,2,3,0.10,8,-5
1202,Josh Karnish (C/LW),Princeton University,29,1,2,3,0.10,19,-4
1203,Ryan Koering (D),Colorado College,30,1,2,3,0.10,2,-7
1204,Andrew Noel (D),Ferris State University,30,1,2,3,0.10,22,-13
1205,Gustavs Ozolins (D),RPI (Rensselaer Polytech. Inst.),31,1,2,3,0.10,2,-4
1206,Filip Sitar (C),University of Connecticut,31,1,2,3,0.10,2,-5
1207,Billy Renfrew (F),Northern Michigan University,31,1,2,3,0.10,2,-10
1208,Cole Miller (D),University of St. Thomas,31,1,2,3,0.10,10,1
1209,Benjamin Poitras (C),Northeastern University,31,1,2,3,0.10,26,-3
1210,Adam Pietila (F),University of Wisconsin,31,1,2,3,0.10,57,0
1211,Will Schimek (D),University of Alaska-Anchorage,32,1,2,3,0.09,27,-9
1212,Joey Musa (F),UMass,33,1,2,3,0.09,6,-7
1213,Blake Dangos (D),American International College,33,1,2,3,0.09,18,-7
1214,Brendan Fitzgerald (D),University of New Hampshire,33,1,2,3,0.09,24,3
1215,Griffin Erdman (F),Northeastern University,37,1,2,3,0.08,2,1
1216,Brady Cleveland (D),Colorado College,37,1,2,3,0.08,39,-3
1217,Leo Gruba (D),University of Minnesota,40,1,2,3,0.08,10,7
1218,A.J. Casperson (D),Long Island University,3,0,3,3,1.00,0,7
1219,Tory Lund (F),Bemidji State University,8,0,3,3,0.38,0,0
1220,Joe Schiller (D),Northern Michigan University,10,0,3,3,0.30,4,-6
1221,Weston Knox (D),University of Wisconsin,11,0,3,3,0.27,4,1
1222,Thomas Haynes (D),Robert Morris University,13,0,3,3,0.23,0,-1
1223,Austin Oravetz (D),Michigan State University,13,0,3,3,0.23,15,4
1224,Heath Armstrong (F),Long Island University,14,0,3,3,0.21,2,1
1225,Jakub Lewandowski (F),Northern Michigan University,17,0,3,3,0.18,4,-1
1226,Wilson Dahlheimer (F),Lake Superior State University,20,0,3,3,0.15,2,-7
1227,Jake Cady (C),Stonehill College,20,0,3,3,0.15,23,-7
1228,Michael Kadlecik (F),Air Force Academy,22,0,3,3,0.14,4,-6
1229,Trym Løkkeberg (C),Dartmouth College,22,0,3,3,0.14,6,2
1230,Maddox Fleming (RW/LW),University of Notre Dame,22,0,3,3,0.14,10,-3
1231,Jack Bar (D),Harvard University,25,0,3,3,0.12,25,0
1232,Nicolas Ardanaz (D),Northern Michigan University,26,0,3,3,0.12,6,-8
1233,Nicholas Fascia (D),Penn State University,27,0,3,3,0.11,13,-6
1234,John Whipple (D),University of Minnesota,29,0,3,3,0.10,6,4
1235,Mathieu Cobetto-Roy (F),RIT (Rochester Inst. of Tech.),29,0,3,3,0.10,12,-5
1236,Jack O'Brien (D),Cornell University,30,0,3,3,0.10,2,4
1237,Bo Cosman (F),UMass,30,0,3,3,0.10,10,4
1238,Duncan Ramsay (D),University of Vermont,32,0,3,3,0.09,6,-3
1239,Connor Welsh (F),College of the Holy Cross,33,0,3,3,0.09,8,-2
1240,Zachary Plucinski (D),University of Notre Dame,34,0,3,3,0.09,18,-9
1241,Owen West (D),Michigan State University,34,0,3,3,0.09,20,9
1242,Mason Reiners (D),St. Cloud State University,36,0,3,3,0.08,4,2
1243,Dean Letourneau (C/RW),Boston College,36,0,3,3,0.08,6,6
1244,Andrew Gilbert (D),Army (U.S. Military Academy),38,0,3,3,0.08,8,-8
1245,Anthony Cipollone (F),Quinnipiac University,38,0,3,3,0.08,9,-1
1246,Hunter Wallace (F),Merrimack College,6,2,0,2,0.33,0,2
1247,William Hallén (C/LW),Miami University (Ohio),9,2,0,2,0.22,4,-4
1248,Vann Yuhas (F),Merrimack College,16,2,0,2,0.13,21,-4
1249,Grayson Arnott (D),University of Maine,20,2,0,2,0.10,4,4
1250,Zackary Tonelli (F),Brown University,25,2,0,2,0.08,6,-1
1251,Stefan Owens (F),UMass-Lowell,26,2,0,2,0.08,0,-4
1252,Gustav Blom (D),RIT (Rochester Inst. of Tech.),26,2,0,2,0.08,8,-1
1253,Jaryd Sych (D),Mercyhurst University,30,2,0,2,0.07,12,-15
1254,Cody Schiavon (D),Canisius College,34,2,0,2,0.06,24,-5
1255,John Gormley (D),Long Island University,34,2,0,2,0.06,26,-3
1256,Caden Brown (C),Ohio State University,3,1,1,2,0.67,0,2
1257,Tanner Ludtke (C),University of Nebraska-Omaha,8,1,1,2,0.25,2,-1
1258,Luke Mylymok (W/C),Niagara University,10,1,1,2,0.20,2,-9
1259,Brandon Lajoie (LW),University of Alaska-Anchorage,11,1,1,2,0.18,0,-1
1260,Ben Troumbly (F),Augustana University,12,1,1,2,0.17,2,-3
1261,Theo Angesved (D),American International College,12,1,1,2,0.17,4,1
1262,Nicholas Wolfenberg (D),Cornell University,13,1,1,2,0.15,2,2
1263,Rylee Hlusiak (RW),Sacred Heart University,14,1,1,2,0.14,0,-1
1264,Ethan Benz (F),Union College,14,1,1,2,0.14,0,-2
1265,Hunter Hastings (F),Stonehill College,16,1,1,2,0.13,4,-4
1266,Pavol Funtek (D),University of Alaska-Anchorage,17,1,1,2,0.12,6,-2
1267,Blais Richartz (F),Michigan Tech,18,1,1,2,0.11,0,-4
1268,Ryan MacPherson (C),University of New Hampshire,18,1,1,2,0.11,2,1
1269,Ethan Warrener (D),University of Alaska-Anchorage,18,1,1,2,0.11,6,-5
1270,Finlay Williams (F),Minnesota State University (Mankato),19,1,1,2,0.11,2,1
1271,Luke Marshall (D),Canisius College,23,1,1,2,0.09,6,0
1272,Callum Gau (F),Augustana University,23,1,1,2,0.09,17,-6
1273,James Fisher (RW/C),Northeastern University,24,1,1,2,0.08,6,-3
1274,Brendan Wang (D),Princeton University,25,1,1,2,0.08,2,0
1275,Kade Turner (D),Ferris State University,25,1,1,2,0.08,4,-10
1276,Brendan Poshak (F),Northern Michigan University,25,1,1,2,0.08,4,-9
1277,Elan Bar-Lev-Wise (C),Yale University,25,1,1,2,0.08,8,-15
1278,Charlie Kinsman (D),University of Vermont,26,1,1,2,0.08,2,-4
1279,Jake Bernadet (F),St. Lawrence University,27,1,1,2,0.07,2,-15
1280,Evan Miller (C),RIT (Rochester Inst. of Tech.),28,1,1,2,0.07,8,-14
1281,Doug Scott (D),RIT (Rochester Inst. of Tech.),28,1,1,2,0.07,10,-15
1282,William Hughes (C),Harvard University,31,1,1,2,0.06,6,-7
1283,Carson Reed (D),University of Alaska-Fairbanks,31,1,1,2,0.06,10,-8
1284,Frankie Carogioiello (C),Miami University (Ohio),32,1,1,2,0.06,24,-12
1285,Quinton Pepper (RW),University of St. Thomas,34,1,1,2,0.06,4,-5
1286,Tyler Carpenter (F),University of Notre Dame,38,1,1,2,0.05,0,-14
1287,Owen Simpson (D),University of Connecticut,5,0,2,2,0.40,0,2
1288,Stephen Willey (LW),Army (U.S. Military Academy),6,0,2,2,0.33,0,0
1289,Thomas Jarman (D),Lindenwood University,8,0,2,2,0.25,2,0
1290,Alex Weiermair (C),University of Denver,9,0,2,2,0.22,0,3
1291,Ryan Forberg (C/RW),Lindenwood University,9,0,2,2,0.22,2,-2
1292,Cooper Haar (LW),Canisius College,9,0,2,2,0.22,4,0
1293,Brady Egan (C),Clarkson University,9,0,2,2,0.22,4,2
1294,Tim Lovell (D),University of Michigan,10,0,2,2,0.20,8,2
1295,Michael Young (F),Princeton University,11,0,2,2,0.18,0,-1
1296,Nathan King (D),Merrimack College,11,0,2,2,0.18,2,-2
1297,Sean Keohane (D),Harvard University,11,0,2,2,0.18,12,-3
1298,Tommy Lyons (F),Harvard University,13,0,2,2,0.15,0,0
1299,Noah Barlage (D),University of Alaska-Fairbanks,15,0,2,2,0.13,2,6
1300,Conner Brown (D),Ferris State University,16,0,2,2,0.13,4,-3
1301,Dean Schwenninger (C),Stonehill College,16,0,2,2,0.13,10,-5
1302,John-Paul Steele (D),University of Alaska-Anchorage,17,0,2,2,0.12,12,0
1303,Tobias Bjercke Larsen (D),American International College,18,0,2,2,0.11,10,-1
1304,Joshua Schenk (F),Dartmouth College,19,0,2,2,0.11,2,-2
1305,Matthew McGroarty (F),Quinnipiac University,20,0,2,2,0.10,2,-4
1306,Nolan Gagnon (D),University of Alaska-Anchorage,20,0,2,2,0.10,4,-1
1307,Leo Schwartz (D),Brown University,20,0,2,2,0.10,6,2
1308,Evan Orloff (D),St. Lawrence University,20,0,2,2,0.10,10,-1
1309,Tucker Ness (D),Arizona State University,21,0,2,2,0.10,6,1
1310,Carson Peters (D),University of St. Thomas,23,0,2,2,0.09,6,5
1311,Jack Page (D),Boston University,23,0,2,2,0.09,14,-2
1312,Brayden Morrison (C/LW),Miami University (Ohio),23,0,2,2,0.09,20,-9
1313,Nate Benoit (D),Quinnipiac University,24,0,2,2,0.08,4,1
1314,Sam Hall (D),St. Lawrence University,24,0,2,2,0.08,8,-9
1315,Ryder Donovan (C/RW),University of St. Thomas,24,0,2,2,0.08,24,-1
1316,David Helledy (D),Bentley University,25,0,2,2,0.08,6,-3
1317,Carter Rose (D),Clarkson University,25,0,2,2,0.08,10,3
1318,Christian Kocsis (LW),Mercyhurst University,25,0,2,2,0.08,10,-20
1319,Griffin Jurecki (LW),Michigan State University,26,0,2,2,0.08,0,-2
1320,A.J. Macaulay (D),Bemidji State University,28,0,2,2,0.07,4,-5
1321,Brehdan Engum (D),Boston University,30,0,2,2,0.07,8,7
1322,Mike Brown (D),Lake Superior State University,30,0,2,2,0.07,47,4
1323,J.R. Ashmead (D),Robert Morris University,33,0,2,2,0.06,14,-6
1324,Oskari Vuorio (C),Dartmouth College,4,1,0,1,0.25,0,2
1325,Mateo Dixon (C),University of Vermont,4,1,0,1,0.25,17,-4
1326,Kevin Marx Norén (RW/LW),RIT (Rochester Inst. of Tech.),5,1,0,1,0.20,0,-2
1327,Jude Brower (D),Army (U.S. Military Academy),6,1,0,1,0.17,0,-5
1328,Jonathan Ziskie (D),Niagara University,7,1,0,1,0.14,0,-1
1329,Luke Amell (D/F),Sacred Heart University,7,1,0,1,0.14,6,0
1330,Oliver Flynn (C),University of Connecticut,8,1,0,1,0.13,2,1
1331,Conor Ronayne (C),Stonehill College,9,1,0,1,0.11,0,-1
1332,Alexi Sylvestre (C/LW),Bemidji State University,9,1,0,1,0.11,0,-3
1333,Michael Citara (RW),Merrimack College,9,1,0,1,0.11,2,-1
1334,Davis Fry (F),Mercyhurst University,11,1,0,1,0.09,4,-3
1335,Niko Jovanovic (C/LW),University of Notre Dame,12,1,0,1,0.08,0,-6
1336,Thomas Daskas (F),University of Michigan,14,1,0,1,0.07,6,-4
1337,Dalton Andrew (RW),University of North Dakota,14,1,0,1,0.07,8,0
1338,Braedon Ford (F),Penn State University,14,1,0,1,0.07,15,-2
1339,Ethan Ullrick (F),Air Force Academy,15,1,0,1,0.07,0,-5
1340,Owen Ozar (F),Bowling Green State University,15,1,0,1,0.07,2,-2
1341,Doug Grimes (RW),Boston University,15,1,0,1,0.07,8,-4
1342,Tucker Hartmann (D),Yale University,16,1,0,1,0.06,2,1
1343,Devon Carlstrom (D),Stonehill College,17,1,0,1,0.06,4,-5
1344,Lynden Grandberg (F),Brown University,20,1,0,1,0.05,4,3
1345,Jack Babbage (D),University of New Hampshire,20,1,0,1,0.05,6,-5
1346,Anthony Calafiore (RW),University of Maine,21,1,0,1,0.05,4,1
1347,Gentry Shamburger (F),Boston College,21,1,0,1,0.05,10,1
1348,John Emmons (C/LW),Miami University (Ohio),21,1,0,1,0.05,29,-14
1349,Riley Stuart (F),Colorado College,21,1,0,1,0.05,36,-7
1350,Ben LeFranc (D),College of the Holy Cross,22,1,0,1,0.05,2,-3
1351,Connor Smith (F),Union College,22,1,0,1,0.05,6,-5
1352,Will Diamond (F),Northern Michigan University,22,1,0,1,0.05,21,-4
1353,Philip Fankl (C),Michigan Tech,23,1,0,1,0.04,0,-4
1354,Jacob Dirks (F),Ferris State University,23,1,0,1,0.04,2,-8
1355,Connor Gourley (F),Robert Morris University,23,1,0,1,0.04,20,-7
1356,Ryan Rosborough (F),St. Cloud State University,28,1,0,1,0.04,4,-7
1357,Eli Sebastian (C),Northeastern University,33,1,0,1,0.03,0,-15
1358,Bennett Zmolek (D),University of North Dakota,1,0,1,1,1.00,0,0
1359,Nick Ahern (LW),University of Vermont,3,0,1,1,0.33,0,-1
1360,Cole Helm (F),Arizona State University,3,0,1,1,0.33,2,1
1361,Thomas Gangl (D),Robert Morris University,4,0,1,1,0.25,0,1
1362,Jack Rogers (F),St. Cloud State University,4,0,1,1,0.25,2,-1
1363,Mario Gasparini (D),University of Vermont,6,0,1,1,0.17,0,-1
1364,Jimmy Rayhill (D),Cornell University,6,0,1,1,0.17,0,0
1365,Coltan Wilkie (F),Lindenwood University,6,0,1,1,0.17,0,-1
1366,Aiden Gallacher (D),University of Nebraska-Omaha,6,0,1,1,0.17,2,0
1367,Nick Strom (D),RPI (Rensselaer Polytech. Inst.),6,0,1,1,0.17,2,0
1368,Charlie Strobel (C),Colorado College,6,0,1,1,0.17,6,3
1369,Tom Richter (F),Union College,7,0,1,1,0.14,0,0
1370,Thomas Manty (F),Brown University,7,0,1,1,0.14,0,0
1371,Edward Moskowitz (LW),College of the Holy Cross,7,0,1,1,0.14,0,0
1372,JD Metz (F/D),University of St. Thomas,7,0,1,1,0.14,2,0
1373,Douglas Andersson (LW),American International College,8,0,1,1,0.13,2,-3
1374,Joseph Blackley (D),Yale University,9,0,1,1,0.11,0,-2
1375,Vitaly Levyy (F),Sacred Heart University,9,0,1,1,0.11,2,0
1376,Nathan Mackie (F),Michigan State University,9,0,1,1,0.11,6,-1
1377,Alexander Tertyshny (D),Stonehill College,9,0,1,1,0.11,7,-5
1378,Bobby Metz (D),Colgate University,10,0,1,1,0.10,0,1
1379,Christian Humphreys (RW/C),University of Michigan,10,0,1,1,0.10,0,-2
1380,Jack Pascucci (D),University of Connecticut,10,0,1,1,0.10,4,2
1381,Trenton Penner (F),University of Alaska-Fairbanks,10,0,1,1,0.10,4,-2
1382,Artur Turansky (LW),Miami University (Ohio),11,0,1,1,0.09,0,-6
1383,Jack Hewitt (D),Brown University,12,0,1,1,0.08,2,-2
1384,Adam O'Marra (C),Robert Morris University,13,0,1,1,0.08,0,-3
1385,Brody Maguire (D),RPI (Rensselaer Polytech. Inst.),13,0,1,1,0.08,8,-3
1386,Andrew King (F),Brown University,14,0,1,1,0.07,0,1
1387,Dylan Godbout (F),Ohio State University,14,0,1,1,0.07,2,-2
1388,Ryan Buckley (D),College of the Holy Cross,14,0,1,1,0.07,4,3
1389,Trevor Mitchell (D),Northern Michigan University,14,0,1,1,0.07,6,-8
1390,Jarrod Smith (F),College of the Holy Cross,14,0,1,1,0.07,8,1
1391,Tyler Dunbar (D),Colorado College,14,0,1,1,0.07,21,1
1392,Anthony Messuri (F),Northeastern University,15,0,1,1,0.07,0,4
1393,Luke Bast (D),University of Minnesota-Duluth,15,0,1,1,0.07,2,-5
1394,Lane Brockhoff (D),Niagara University,15,0,1,1,0.07,4,0
1395,Daniel Buchbinder (D),UMass-Lowell,15,0,1,1,0.07,4,-1
1396,Jack Malinski (D),University of Vermont,15,0,1,1,0.07,6,1
1397,Jack Collins (F),UMass-Lowell,16,0,1,1,0.06,0,2
1398,Isaiah Norlin (D),University of Nebraska-Omaha,16,0,1,1,0.06,2,-2
1399,Dominic Foglia (D),Colgate University,16,0,1,1,0.06,4,5
1400,Adam Barone (D),Lake Superior State University,17,0,1,1,0.06,4,-6
1401,Alexander Servagno (F),Penn State University,17,0,1,1,0.06,4,0
1402,Ivan Korodiuk (D),Bowling Green State University,17,0,1,1,0.06,4,0
1403,Josh Phillips (D),Union College,18,0,1,1,0.06,2,-2
1404,Luke Roelofs (D),Bemidji State University,18,0,1,1,0.06,6,-6
1405,Jacob Vockler (F),Lindenwood University,19,0,1,1,0.05,4,-5
1406,Colby Browne (F),Northern Michigan University,19,0,1,1,0.05,6,-6
1407,Colin Grable (D),Dartmouth College,19,0,1,1,0.05,8,1
1408,Cameron Mannion (D),Stonehill College,20,0,1,1,0.05,2,-1
1409,Garrett Valk (D),Long Island University,20,0,1,1,0.05,2,3
1410,Kaden Muir (D),Mercyhurst University,21,0,1,1,0.05,16,-16
1411,Billy Norcross (C/RW),Northeastern University,22,0,1,1,0.05,2,-1
1412,Cal Mell (D),Union College,24,0,1,1,0.04,6,-2
1413,Tucker McRae (D),Dartmouth College,26,0,1,1,0.04,6,-10
1414,Mike Murtagh (F),University of Connecticut,28,0,1,1,0.04,4,-7
1415,Grayden Daul (D),Northern Michigan University,28,0,1,1,0.04,16,-5
1416,Ryan Williams (D),RIT (Rochester Inst. of Tech.),29,0,1,1,0.03,8,-10
1417,Finn Loftus (D),UMass,31,0,1,1,0.03,4,3
1418,EJ Emery (D),University of North Dakota,31,0,1,1,0.03,40,3
1419,Aiden Yakimchuk (D),Lindenwood University,32,0,1,1,0.03,4,-5
1420,Jack Henry (D),Northeastern University,32,0,1,1,0.03,6,-9
1421,Cameron Kungle (D),Merrimack College,32,0,1,1,0.03,12,-4
1422,Hunter Hady (D),University of Michigan,32,0,1,1,0.03,35,-2
1423,Jake Peterson (D),Air Force Academy,36,0,1,1,0.03,2,-2
1424,Seth Constance (D),Northeastern University,36,0,1,1,0.03,4,-4
1425,Tory Pitner (D),University of Denver,40,0,1,1,0.03,21,3
1426,Peter Frates (D),Harvard University,0,0,0,0,0.00,0,0
1427,Jack Cronin (RW),Princeton University,0,0,0,0,0.00,0,0
1428,Brendan Kennette (D),Sacred Heart University,0,0,0,0,0.00,0,0
1429,Michael Salandra (F),Quinnipiac University,0,0,0,0,0.00,0,0
1430,Mateo Picozzi (D),Mercyhurst University,0,0,0,0,0.00,0,0
1431,Harry Meirowitz (D),Brown University,0,0,0,0,0.00,0,0
1432,Liam Hansson (C/D),Air Force Academy,0,0,0,0,0.00,0,0
1433,Lucas Coon (F),Air Force Academy,0,0,0,0,0.00,0,0
1434,Bauer Swift (D),University of Connecticut,0,0,0,0,0.00,0,0
1435,Michael Bevilacqua (D),Bowling Green State University,0,0,0,0,0.00,0,0
1436,Roc Truman (F),UMass-Lowell,0,0,0,0,0.00,0,0
1437,David Hejduk (D),Harvard University,0,0,0,0,0.00,0,0
1438,Mathieu Bourgault (LW),RPI (Rensselaer Polytech. Inst.),0,0,0,0,0.00,0,0
1439,Ryan Kusler (F),Western Michigan University,0,0,0,0,0.00,0,0
1440,Geno McEnery (RW),Providence College,0,0,0,0,0.00,0,0
1441,Luke Devlin (C),Cornell University,0,0,0,0,0.00,0,0
1442,Eli Pilosof (C),Union College,0,0,0,0,0.00,0,0
1443,Danylo Korzhyletskyi (F),American International College,0,0,0,0,0.00,0,0
1444,Brian Morse (D),University of Maine,0,0,0,0,0.00,0,0
1445,Winter Wallace (RW),Cornell University,0,0,0,0,0.00,0,0
1446,Cooper Boulanger (F),Air Force Academy,0,0,0,0,0.00,0,0
1447,Owen Desilets (D),Dartmouth College,0,0,0,0,0.00,0,0
1448,Jackson Reineke (RW/LW),Robert Morris University,0,0,0,0,0.00,0,0
1449,Jack Richard (F),Merrimack College,0,0,0,0,0.00,0,0
1450,Tommy Bannister (F),Mercyhurst University,0,0,0,0,0.00,0,0
1451,Mark Hillier (F),Merrimack College,0,0,0,0,0.00,0,0
1452,Will McDonough (C),Harvard University,0,0,0,0,0.00,0,0
1453,Connor Brown (F),Western Michigan University,0,0,0,0,0.00,0,0
1454,Paul Davey (LW),Boston College,0,0,0,0,0.00,0,0
1455,Kevin Fitzgerald (D),University of Connecticut,0,0,0,0,0.00,0,0
1456,Charlie Lieberman (D),UMass,0,0,0,0,0.00,0,0
1457,Nick Baer (D),Colorado College,0,0,0,0,0.00,0,0
1458,Max Rud (D),University of Minnesota,0,0,0,0,0.00,0,0
1459,Kaden Nelson (F),Michigan State University,0,0,0,0,0.00,0,0
1460,Sam Rice (F),Minnesota State University (Mankato),0,0,0,0,0.00,0,0
1461,Samo Meritähti (D),Providence College,0,0,0,0,0.00,0,0
1462,Andrew Kuzma (C),Penn State University,0,0,0,0,0.00,0,0
1463,Marc Lund (F),Northeastern University,0,0,0,0,0.00,0,0
1464,Jordan Tonelli (C/LW),RPI (Rensselaer Polytech. Inst.),0,0,0,0,0.00,0,0
1465,Cole Craft (RW),Lake Superior State University,0,0,0,0,0.00,0,0
1466,Trevor Russell (D),Michigan Tech,0,0,0,0,0.00,0,0
1467,Jackson Munro (D),Brown University,0,0,0,0,0.00,0,0
1468,Nick Grimaldi (F),Ferris State University,0,0,0,0,0.00,0,0
1469,Sebastian Tamburro (LW),Colgate University,0,0,0,0,0.00,0,0
1470,Miles Gust (D),University of Michigan,0,0,0,0,0.00,0,0
1471,Grady Gallatin (D),Western Michigan University,0,0,0,0,0.00,0,0
1472,Hunter Mullett (D),Arizona State University,0,0,0,0,0.00,0,0
1473,Dylan Cook (LW),UMass-Lowell,0,0,0,0,0.00,0,0
1474,David Grosek (C/LW),Miami University (Ohio),0,0,0,0,0.00,0,0
1475,Nicky Wallace (D),American International College,1,0,0,0,0.00,0,0
1476,Quinn Disher (F),Michigan Tech,1,0,0,0,0.00,0,0
1477,Joey Dosan (F),Army (U.S. Military Academy),1,0,0,0,0.00,0,0
1478,Hunter McCurdy (D),American International College,1,0,0,0,0.00,0,0
1479,Aaron Grounds (F),Long Island University,1,0,0,0,0.00,0,0
1480,Adam Schankula (F),Bowling Green State University,1,0,0,0,0.00,0,0
1481,Michael Schermerhorn (C/LW),University of Notre Dame,1,0,0,0,0.00,0,-1
1482,Ryan Gillespie (RW),Canisius College,1,0,0,0,0.00,0,0
1483,Tim Delay (RW),Boston College,1,0,0,0,0.00,0,0
1484,Tyler Miller (D),Michigan Tech,1,0,0,0,0.00,0,0
1485,Tyler Waram (D),University of Alaska-Fairbanks,1,0,0,0,0.00,0,0
1486,Jordan Brisson (F),Colorado College,1,0,0,0,0.00,0,-1
1487,Jake LaRusso (F),Stonehill College,1,0,0,0,0.00,0,-1
1488,Luke Khozozian (F),Harvard University,1,0,0,0,0.00,0,0
1489,Austin Salani (F),Dartmouth College,1,0,0,0,0.00,2,-1
1490,Brian Silver (D),Miami University (Ohio),1,0,0,0,0.00,15,0
1491,Christian MacDougall (F),Canisius College,1,0,0,0,0.00,17,1
1492,Caden Lewandowski (D),Clarkson University,2,0,0,0,0.00,0,-1
1493,Noah Wakeford (F),Brown University,2,0,0,0,0.00,0,0
1494,George Grannis (F),Clarkson University,2,0,0,0,0.00,0,1
1495,Brayden Krieger (F),Bowling Green State University,2,0,0,0,0.00,0,-1
1496,Jordan Hughesman (F),Merrimack College,2,0,0,0,0.00,0,-1
1497,Jason Marsella (D),Yale University,2,0,0,0,0.00,0,-2
1498,Cameron Ricotta (LW),Mercyhurst University,2,0,0,0,0.00,0,-4
1499,Matt Cato (C),University of Vermont,2,0,0,0,0.00,0,-1
1500,Jaiden Moriello (RW),UMass-Lowell,2,0,0,0,0.00,0,-1
1501,Trevor Stachowiak (F),University of Minnesota-Duluth,2,0,0,0,0.00,0,-2
1502,Julian Facchinelli (RW),Princeton University,2,0,0,0,0.00,0,0
1503,Owen Forester (D),Yale University,2,0,0,0,0.00,0,-3
1504,Marian Mosko (D),Cornell University,2,0,0,0,0.00,0,-1
1505,Zach Hahn (D),University of New Hampshire,2,0,0,0,0.00,0,0
1506,Zach Bade (F),Western Michigan University,2,0,0,0,0.00,2,0
1507,Justin Barker (RW),Stonehill College,2,0,0,0,0.00,2,-2
1508,Jase Sofo (D),University of St. Thomas,2,0,0,0,0.00,4,-1
1509,Dana Wallace (F),St. Cloud State University,2,0,0,0,0.00,4,0
1510,Andrew Garby (D),Army (U.S. Military Academy),2,0,0,0,0.00,12,0
1511,Xan Gurney (D),Long Island University,2,0,0,0,0.00,15,1
1512,Noah Alvarez (F),Army (U.S. Military Academy),3,0,0,0,0.00,0,-2
1513,Chase Ramsay (D),Quinnipiac University,3,0,0,0,0.00,0,0
1514,Rainers Darzins (RW),Niagara University,3,0,0,0,0.00,0,-2
1515,Jack Gorton (RW),Boston University,3,0,0,0,0.00,0,-1
1516,Will Jones (D),Air Force Academy,3,0,0,0,0.00,0,1
1517,Riley Rosenthal (D),Stonehill College,3,0,0,0,0.00,0,-2
1518,Dean Spak (F),University of Alaska-Fairbanks,3,0,0,0,0.00,0,-1
1519,Lee Chiang (F),Robert Morris University,3,0,0,0,0.00,0,0
1520,Kyle Furey (D),Northeastern University,3,0,0,0,0.00,0,-1
1521,Hunter Weiss (D),University of Notre Dame,3,0,0,0,0.00,0,0
1522,Luke Lisko (C),Ferris State University,3,0,0,0,0.00,2,-3
1523,Willyam Gendron (C),Sacred Heart University,3,0,0,0,0.00,2,0
1524,Alex Gaffney (C),Harvard University,4,0,0,0,0.00,0,0
1525,Kade Nielsen (F),Minnesota State University (Mankato),4,0,0,0,0.00,0,0
1526,Will Traeger (C),Boston College,4,0,0,0,0.00,0,-1
1527,Josh Bohlin (F),Army (U.S. Military Academy),4,0,0,0,0.00,0,-2
1528,Christian Jimenez (D),Harvard University,4,0,0,0,0.00,0,-1
1529,Nicholas O'Hanisain (D),Bowling Green State University,4,0,0,0,0.00,0,0
1530,Keegan Langefels (D),Canisius College,4,0,0,0,0.00,0,0
1531,Ean Somoza (F),Western Michigan University,4,0,0,0,0.00,0,0
1532,Isaac MacLeod (RW),St. Lawrence University,4,0,0,0,0.00,0,0
1533,Matthew Brille (F),Brown University,4,0,0,0,0.00,2,1
1534,Parker Murray (F),Cornell University,4,0,0,0,0.00,2,0
1535,Dominick Rivelli (RW),UMass-Lowell,4,0,0,0,0.00,2,0
1536,Alexi Van Houtte-Cachero (RW/C),University of Nebraska-Omaha,4,0,0,0,0.00,4,-2
1537,Bryce Monrean (F),University of Alaska-Fairbanks,4,0,0,0,0.00,6,0
1538,Ethan Fredericks (F),Northeastern University,5,0,0,0,0.00,0,0
1539,Eric DeDobbelaer (C/RW),Robert Morris University,5,0,0,0,0.00,0,-2
1540,Oliver Bezick (D),Michigan Tech,5,0,0,0,0.00,0,0
1541,Jack Mesic (D),Western Michigan University,5,0,0,0,0.00,0,0
1542,Connor MacPherson (RW),University of New Hampshire,5,0,0,0,0.00,0,-1
1543,James Callahan (D),Air Force Academy,5,0,0,0,0.00,0,-3
1544,Hunter Jones (F),American International College,5,0,0,0,0.00,0,-2
1545,Luke Buss (F),University of Wisconsin,5,0,0,0,0.00,0,-2
1546,Noah Eyre (F),Quinnipiac University,5,0,0,0,0.00,0,0
1547,Kazimier Sobieski (D),UMass,5,0,0,0,0.00,2,1
1548,Nicholas Mikan (RW),University of St. Thomas,5,0,0,0,0.00,2,-2
1549,Lucas Kanta (LW),Army (U.S. Military Academy),5,0,0,0,0.00,2,-3
1550,Peter Lajoy (F),University of Denver,5,0,0,0,0.00,2,0
1551,Aidan Carney (F),University of Maine,5,0,0,0,0.00,2,0
1552,Nolan Hayes (D),Northeastern University,5,0,0,0,0.00,2,0
1553,Kolby Amici (F),Bentley University,5,0,0,0,0.00,2,-3
1554,Will Francis (D),University of Minnesota-Duluth,5,0,0,0,0.00,5,-3
1555,Carter Theissen (D),Augustana University,6,0,0,0,0.00,0,-3
1556,Evan Mitchell (D),St. Lawrence University,6,0,0,0,0.00,0,-3
1557,Cameron Dunn (C),UMass,6,0,0,0,0.00,0,0
1558,Ryan Davies (D),Stonehill College,6,0,0,0,0.00,2,-3
1559,Cade Alami (D),Minnesota State University (Mankato),6,0,0,0,0.00,4,-1
1560,Kyler Head (F),Mercyhurst University,6,0,0,0,0.00,6,-3
1561,Jack Blanchett (D),Lake Superior State University,6,0,0,0,0.00,6,-2
1562,Matteo Pecchia (LW),University of Alaska-Fairbanks,6,0,0,0,0.00,6,-1
1563,John Larkin (D),Ohio State University,7,0,0,0,0.00,0,0
1564,Jacob Bonkowski (F),Minnesota State University (Mankato),7,0,0,0,0.00,0,1
1565,Alec Whipple (D),University of Denver,7,0,0,0,0.00,0,0
1566,Tyler Haskins (F),Minnesota State University (Mankato),7,0,0,0,0.00,0,0
1567,Cameron Gendron (F),Providence College,7,0,0,0,0.00,0,0
1568,Trevor Smith (C),Army (U.S. Military Academy),7,0,0,0,0.00,0,-5
1569,Tanner Willick (D),American International College,7,0,0,0,0.00,2,-2
1570,Ryan Henderson (D),Bemidji State University,7,0,0,0,0.00,2,-3
1571,Joshua Wildauer (C),Lake Superior State University,7,0,0,0,0.00,2,-2
1572,Dawson Good (F),University of Vermont,7,0,0,0,0.00,2,-3
1573,Adam Raesler (F),Lindenwood University,7,0,0,0,0.00,4,-2
1574,Seth Bernard-Docker (D),Bentley University,8,0,0,0,0.00,0,-2
1575,Joshua Orrico (D),University of Michigan,8,0,0,0,0.00,0,-3
1576,Sean Kilcullen (D),UMass-Lowell,8,0,0,0,0.00,0,-1
1577,Eli Barnett (D),University of Vermont,8,0,0,0,0.00,2,6
1578,Pat Lawn (D),Bentley University,8,0,0,0,0.00,2,2
1579,Hadley Hudak (F),Lake Superior State University,8,0,0,0,0.00,4,-4
1580,Brendan Dumas (F),Sacred Heart University,8,0,0,0,0.00,8,-2
1581,Owen Nolan (D),Army (U.S. Military Academy),8,0,0,0,0.00,10,-2
1582,Patrick Reilly (D),Princeton University,9,0,0,0,0.00,2,-1
1583,Chris Romaine (D),Ohio State University,9,0,0,0,0.00,4,2
1584,Johannes Løkkeberg (C),Bowling Green State University,9,0,0,0,0.00,4,-2
1585,Jake Ratzlaff (D),University of St. Thomas,9,0,0,0,0.00,11,0
1586,Carl Fish (D),Providence College,10,0,0,0,0.00,0,-3
1587,Jojo Tanaka-Campbell (F),Yale University,10,0,0,0,0.00,2,-6
1588,Teodor Forssander (LW),Miami University (Ohio),11,0,0,0,0.00,0,-5
1589,Kaleb Tiessen (D),St. Cloud State University,11,0,0,0,0.00,2,-3
1590,Brandon Santa Juana (F),Bowling Green State University,11,0,0,0,0.00,2,-3
1591,Wyatt Schlaht (F),Brown University,11,0,0,0,0.00,2,-2
1592,Max Wattvil (D),Merrimack College,11,0,0,0,0.00,4,-3
1593,Will Hilfiker (D),University of Alaska-Fairbanks,11,0,0,0,0.00,15,5
1594,David Côté (D),Union College,12,0,0,0,0.00,2,-1
1595,Emerson Goode (C/W),Ferris State University,12,0,0,0,0.00,6,-9
1596,Jason Gallucci (D),Penn State University,12,0,0,0,0.00,8,1
1597,Jasper Lester (D),Air Force Academy,12,0,0,0,0.00,23,0
1598,Jack Blake (D),Bowling Green State University,13,0,0,0,0.00,2,1
1599,Josh Player (D),University of New Hampshire,13,0,0,0,0.00,2,-6
1600,Spencer Evans (D),Brown University,13,0,0,0,0.00,2,0
